"Name","No_worker","Worker_1","Workers_2","Workers_3_or_more","Total_Housing_Units","Occupied_Housing","Vacant_Housing","Owner_Occupied_Housing","Renter_Occupied_Housing","Total_Multiunit_Housing","Median_Houshold_Income","STATEFP","COUNTYFP","STATE_FIPS","Year"
"Census Tract 190.04, Davidson County, Tennessee","234","615","569","109","1545","1527","18","560","967","1545","44001","47","037","47037","2020"
"Census Tract 190.07, Davidson County, Tennessee","263","346","192","107","1025","908","117","425","483","1025","48485","47","037","47037","2020"
"Census Tract 190.08, Davidson County, Tennessee","389","828","550","248","2178","2015","163","902","1113","2178","50512","47","037","47037","2020"
"Census Tract 191.05, Davidson County, Tennessee","513","876","575","207","2453","2171","282","612","1559","2453","48271","47","037","47037","2020"
"Census Tract 191.06, Davidson County, Tennessee","188","807","798","98","2078","1891","187","796","1095","2078","65323","47","037","47037","2020"
"Census Tract 191.08, Davidson County, Tennessee","202","663","228","123","1283","1216","67","285","931","1283","34893","47","037","47037","2020"
"Census Tract 191.09, Davidson County, Tennessee","295","528","628","142","1704","1593","111","1203","390","1704","57039","47","037","47037","2020"
"Census Tract 191.10, Davidson County, Tennessee","184","464","392","153","1250","1193","57","854","339","1250","55553","47","037","47037","2020"
"Census Tract 191.11, Davidson County, Tennessee","229","980","456","197","2082","1862","220","468","1394","2082","47700","47","037","47037","2020"
"Census Tract 191.12, Davidson County, Tennessee","215","727","723","179","1958","1844","114","1256","588","1958","69821","47","037","47037","2020"
"Census Tract 191.15, Davidson County, Tennessee","266","476","571","80","1521","1393","128","1213","180","1521","121094","47","037","47037","2020"
"Census Tract 191.16, Davidson County, Tennessee","237","1370","903","380","3109","2890","219","1779","1111","3109","77293","47","037","47037","2020"
"Census Tract 191.17, Davidson County, Tennessee","125","702","735","161","1740","1723","17","1298","425","1740","91602","47","037","47037","2020"
"Census Tract 191.18, Davidson County, Tennessee","119","1310","757","148","2670","2334","336","420","1914","2670","56881","47","037","47037","2020"
"Census Tract 191.19, Davidson County, Tennessee","353","711","1561","206","3031","2831","200","2500","331","3031","104307","47","037","47037","2020"
"Census Tract 191.20, Davidson County, Tennessee","171","1106","775","51","2243","2103","140","1065","1038","2243","84365","47","037","47037","2020"
"Census Tract 191.21, Davidson County, Tennessee","43","504","795","0","1467","1342","125","961","381","1467","110233","47","037","47037","2020"
"Census Tract 192, Davidson County, Tennessee","190","666","437","170","1666","1463","203","609","854","1666","64760","47","037","47037","2020"
"Census Tract 193, Davidson County, Tennessee","651","758","100","43","1681","1552","129","72","1480","1681","18387","47","037","47037","2020"
"Census Tract 194.01, Davidson County, Tennessee","305","658","306","77","1972","1346","626","367","979","1972","52571","47","037","47037","2020"
"Census Tract 194.02, Davidson County, Tennessee","127","1159","943","23","2742","2252","490","706","1546","2742","92939","47","037","47037","2020"
"Census Tract 195.01, Davidson County, Tennessee","271","1051","321","0","2214","1643","571","93","1550","2214","70231","47","037","47037","2020"
"Census Tract 195.02, Davidson County, Tennessee","106","1789","297","0","3273","2192","1081","528","1664","3273","66982","47","037","47037","2020"
"Census Tract 195.03, Davidson County, Tennessee","120","1441","360","0","3233","1921","1312","500","1421","3233","85335","47","037","47037","2020"
"Census Tract 196, Davidson County, Tennessee","280","669","511","165","1882","1625","257","623","1002","1882","60951","47","037","47037","2020"
"Census Tract 9801, Davidson County, Tennessee","0","0","0","0","0","0","0","0","0","0","-666666666","47","037","47037","2020"
"Census Tract 9802, Davidson County, Tennessee","0","0","0","0","0","0","0","0","0","0","-666666666","47","037","47037","2020"
"Census Tract 9550.01, Decatur County, Tennessee","280","268","147","22","1433","717","716","633","84","1433","42332","47","039","47039","2020"
"Census Tract 9550.03, Decatur County, Tennessee","366","220","232","69","1204","887","317","640","247","1204","33854","47","039","47039","2020"
"Census Tract 9550.04, Decatur County, Tennessee","497","234","237","0","1187","968","219","702","266","1187","29717","47","039","47039","2020"
"Census Tract 9551.01, Decatur County, Tennessee","276","254","165","14","1084","709","375","571","138","1084","41094","47","039","47039","2020"
"Census Tract 9551.02, Decatur County, Tennessee","551","479","295","31","2021","1356","665","1149","207","2021","47368","47","039","47039","2020"
"Census Tract 9201.01, DeKalb County, Tennessee","517","287","218","55","1756","1077","679","872","205","1756","61042","47","041","47041","2020"
"Census Tract 9201.02, DeKalb County, Tennessee","624","738","472","73","2295","1907","388","1487","420","2295","50869","47","041","47041","2020"
"Census Tract 9202.01, DeKalb County, Tennessee","645","791","410","0","2043","1846","197","779","1067","2043","33510","47","041","47041","2020"
"Census Tract 9202.02, DeKalb County, Tennessee","294","213","213","32","887","752","135","481","271","887","51833","47","041","47041","2020"
"Census Tract 9203, DeKalb County, Tennessee","803","634","716","47","2705","2200","505","1695","505","2705","45292","47","041","47041","2020"
"Census Tract 601, Dickson County, Tennessee","582","582","371","62","2002","1597","405","1309","288","2002","54507","47","043","47043","2020"
"Census Tract 602.01, Dickson County, Tennessee","481","459","152","55","1542","1147","395","917","230","1542","45673","47","043","47043","2020"
"Census Tract 602.02, Dickson County, Tennessee","401","410","328","98","1341","1237","104","903","334","1341","60335","47","043","47043","2020"
"Census Tract 603, Dickson County, Tennessee","693","1023","690","217","3002","2623","379","1947","676","3002","55620","47","043","47043","2020"
"Census Tract 604.01, Dickson County, Tennessee","203","364","492","52","1233","1111","122","1006","105","1233","82092","47","043","47043","2020"
"Census Tract 604.02, Dickson County, Tennessee","529","800","1055","233","2760","2617","143","2457","160","2760","78841","47","043","47043","2020"
"Census Tract 605.01, Dickson County, Tennessee","605","983","713","87","2762","2388","374","1639","749","2762","58520","47","043","47043","2020"
"Census Tract 605.02, Dickson County, Tennessee","393","385","218","38","1174","1034","140","762","272","1174","55988","47","043","47043","2020"
"Census Tract 804.01, Robertson County, Tennessee","435","608","624","51","1929","1718","211","836","882","1929","48841","47","147","47147","2020"
"Census Tract 804.02, Robertson County, Tennessee","509","663","534","44","1850","1750","100","1095","655","1850","44896","47","147","47147","2020"
"Census Tract 805, Robertson County, Tennessee","323","692","669","144","1947","1828","119","1672","156","1947","67059","47","147","47147","2020"
"Census Tract 806.03, Robertson County, Tennessee","455","758","398","174","1968","1785","183","1521","264","1968","74854","47","147","47147","2020"
"Census Tract 806.04, Robertson County, Tennessee","443","392","503","136","1485","1474","11","1264","210","1485","67978","47","147","47147","2020"
"Census Tract 806.05, Robertson County, Tennessee","276","419","342","108","1145","1145","0","992","153","1145","69055","47","147","47147","2020"
"Census Tract 806.06, Robertson County, Tennessee","524","753","803","162","2359","2242","117","1793","449","2359","71500","47","147","47147","2020"
"Census Tract 807.01, Robertson County, Tennessee","216","285","685","59","1338","1245","93","980","265","1338","89556","47","147","47147","2020"
"Census Tract 807.02, Robertson County, Tennessee","332","519","540","160","1551","1551","0","1295","256","1551","95861","47","147","47147","2020"
"Census Tract 401.01, Rutherford County, Tennessee","229","426","455","146","1299","1256","43","941","315","1299","75294","47","149","47149","2020"
"Census Tract 401.02, Rutherford County, Tennessee","134","332","607","83","1223","1156","67","840","316","1223","71723","47","149","47149","2020"
"Census Tract 401.04, Rutherford County, Tennessee","239","1096","592","143","2141","2070","71","1270","800","2141","45374","47","149","47149","2020"
"Census Tract 401.05, Rutherford County, Tennessee","210","466","676","121","1574","1473","101","1112","361","1574","66496","47","149","47149","2020"
"Census Tract 401.06, Rutherford County, Tennessee","77","448","687","67","1405","1279","126","825","454","1405","60370","47","149","47149","2020"
"Census Tract 401.07, Rutherford County, Tennessee","140","556","660","236","1768","1592","176","1137","455","1768","67731","47","149","47149","2020"
"Census Tract 402, Rutherford County, Tennessee","205","690","276","214","1385","1385","0","1037","348","1385","72917","47","149","47149","2020"
"Census Tract 403.03, Rutherford County, Tennessee","217","491","240","84","1083","1032","51","488","544","1083","52574","47","149","47149","2020"
"Census Tract 403.04, Rutherford County, Tennessee","192","650","486","64","1464","1392","72","777","615","1464","55511","47","149","47149","2020"
"Census Tract 403.05, Rutherford County, Tennessee","340","319","204","131","994","994","0","406","588","994","22419","47","149","47149","2020"
"Census Tract 403.07, Rutherford County, Tennessee","152","273","589","61","1144","1075","69","1060","15","1144","111202","47","149","47149","2020"
"Census Tract 403.08, Rutherford County, Tennessee","480","1230","693","130","2721","2533","188","1556","977","2721","62176","47","149","47149","2020"
"Census Tract 403.09, Rutherford County, Tennessee","169","587","794","301","1851","1851","0","1596","255","1851","84564","47","149","47149","2020"
"Census Tract 403.10, Rutherford County, Tennessee","252","404","421","169","1335","1246","89","1157","89","1335","63698","47","149","47149","2020"
"Census Tract 403.11, Rutherford County, Tennessee","269","469","385","224","1411","1347","64","567","780","1411","70485","47","149","47149","2020"
"Census Tract 403.12, Rutherford County, Tennessee","112","524","334","104","1218","1074","144","128","946","1218","72200","47","149","47149","2020"
"Census Tract 404.04, Rutherford County, Tennessee","341","320","369","106","1190","1136","54","787","349","1190","59625","47","149","47149","2020"
"Census Tract 404.05, Rutherford County, Tennessee","187","750","623","83","1722","1643","79","632","1011","1722","50295","47","149","47149","2020"
"Census Tract 405.01, Rutherford County, Tennessee","453","937","1137","344","2965","2871","94","2596","275","2965","86853","47","149","47149","2020"
"Census Tract 405.02, Rutherford County, Tennessee","414","1112","1013","197","3010","2736","274","2467","269","3010","80565","47","149","47149","2020"
"Census Tract 406, Rutherford County, Tennessee","365","650","566","204","1894","1785","109","1656","129","1894","70446","47","149","47149","2020"
"Census Tract 407.02, Rutherford County, Tennessee","365","756","985","155","2576","2261","315","1898","363","2576","80958","47","149","47149","2020"
"Census Tract 407.03, Rutherford County, Tennessee","342","1133","936","451","2963","2862","101","2343","519","2963","77688","47","149","47149","2020"
"Census Tract 407.04, Rutherford County, Tennessee","237","454","659","186","1564","1536","28","1433","103","1564","87016","47","149","47149","2020"
"Census Tract 408.06, Rutherford County, Tennessee","495","845","1001","337","2739","2678","61","2449","229","2739","94554","47","149","47149","2020"
"Census Tract 408.07, Rutherford County, Tennessee","445","763","801","306","2315","2315","0","2101","214","2315","91989","47","149","47149","2020"
"Census Tract 408.08, Rutherford County, Tennessee","336","845","1408","367","3068","2956","112","2723","233","3068","110227","47","149","47149","2020"
"Census Tract 408.09, Rutherford County, Tennessee","338","529","694","44","1695","1605","90","1500","105","1695","69383","47","149","47149","2020"
"Census Tract 408.10, Rutherford County, Tennessee","288","362","370","65","1189","1085","104","938","147","1189","66424","47","149","47149","2020"
"Census Tract 408.11, Rutherford County, Tennessee","259","692","747","331","2029","2029","0","1898","131","2029","99955","47","149","47149","2020"
"Census Tract 408.12, Rutherford County, Tennessee","235","395","358","76","1142","1064","78","891","173","1142","69340","47","149","47149","2020"
"Census Tract 409.01, Rutherford County, Tennessee","353","1001","495","88","2195","1937","258","707","1230","2195","51716","47","149","47149","2020"
"Census Tract 409.04, Rutherford County, Tennessee","261","757","620","184","1894","1822","72","1495","327","1894","79478","47","149","47149","2020"
"Census Tract 409.06, Rutherford County, Tennessee","231","797","1091","129","2248","2248","0","1188","1060","2248","81123","47","149","47149","2020"
"Census Tract 409.07, Rutherford County, Tennessee","462","1608","1590","174","3887","3834","53","2266","1568","3887","79521","47","149","47149","2020"
"Census Tract 606.01, Dickson County, Tennessee","467","546","487","25","1653","1525","128","1092","433","1653","55063","47","043","47043","2020"
"Census Tract 606.02, Dickson County, Tennessee","679","898","873","140","2605","2590","15","1446","1144","2605","44823","47","043","47043","2020"
"Census Tract 607, Dickson County, Tennessee","447","856","349","38","2023","1690","333","1413","277","2023","49071","47","043","47043","2020"
"Census Tract 9640.01, Dyer County, Tennessee","739","513","532","37","1996","1821","175","1286","535","1996","41435","47","045","47045","2020"
"Census Tract 9640.02, Dyer County, Tennessee","167","380","301","11","960","859","101","575","284","960","59175","47","045","47045","2020"
"Census Tract 9642, Dyer County, Tennessee","845","985","759","102","3011","2691","320","1505","1186","3011","50411","47","045","47045","2020"
"Census Tract 9643, Dyer County, Tennessee","654","743","631","54","2354","2082","272","805","1277","2354","39339","47","045","47045","2020"
"Census Tract 9644.01, Dyer County, Tennessee","571","464","199","74","1470","1308","162","679","629","1470","39867","47","045","47045","2020"
"Census Tract 9644.02, Dyer County, Tennessee","436","721","127","23","1387","1307","80","543","764","1387","28467","47","045","47045","2020"
"Census Tract 9645, Dyer County, Tennessee","245","289","338","34","979","906","73","726","180","979","56500","47","045","47045","2020"
"Census Tract 9646, Dyer County, Tennessee","551","222","298","52","1338","1123","215","777","346","1338","33073","47","045","47045","2020"
"Census Tract 9648, Dyer County, Tennessee","393","266","437","58","1307","1154","153","897","257","1307","47826","47","045","47045","2020"
"Census Tract 9649, Dyer County, Tennessee","441","909","612","58","2131","2020","111","1725","295","2131","57122","47","045","47045","2020"
"Census Tract 603, Fayette County, Tennessee","472","501","236","32","1373","1241","132","736","505","1373","38909","47","047","47047","2020"
"Census Tract 604.01, Fayette County, Tennessee","292","372","337","54","1154","1055","99","891","164","1154","82132","47","047","47047","2020"
"Census Tract 604.02, Fayette County, Tennessee","353","596","475","86","1568","1510","58","1288","222","1568","72929","47","047","47047","2020"
"Census Tract 604.03, Fayette County, Tennessee","315","645","537","66","1637","1563","74","1363","200","1637","74526","47","047","47047","2020"
"Census Tract 604.04, Fayette County, Tennessee","489","959","887","104","2569","2439","130","2139","300","2569","75252","47","047","47047","2020"
"Census Tract 605.01, Fayette County, Tennessee","773","530","350","24","1898","1677","221","1072","605","1898","48388","47","047","47047","2020"
"Census Tract 605.02, Fayette County, Tennessee","519","532","361","46","1619","1458","161","1076","382","1619","48750","47","047","47047","2020"
"Census Tract 606, Fayette County, Tennessee","712","560","363","18","1963","1653","310","1285","368","1963","52379","47","047","47047","2020"
"Census Tract 607.01, Fayette County, Tennessee","291","452","229","48","1087","1020","67","804","216","1087","70417","47","047","47047","2020"
"Census Tract 607.02, Fayette County, Tennessee","437","495","419","117","1548","1468","80","1263","205","1548","99038","47","047","47047","2020"
"Census Tract 608, Fayette County, Tennessee","361","244","300","51","1020","956","64","670","286","1020","60333","47","047","47047","2020"
"Census Tract 9650, Fentress County, Tennessee","710","505","188","94","1899","1497","402","1230","267","1899","42302","47","049","47049","2020"
"Census Tract 9651, Fentress County, Tennessee","915","596","305","12","2326","1828","498","854","974","2326","24868","47","049","47049","2020"
"Census Tract 9652.01, Fentress County, Tennessee","361","237","270","11","1045","879","166","779","100","1045","36033","47","049","47049","2020"
"Census Tract 9652.02, Fentress County, Tennessee","415","366","283","50","1561","1114","447","923","191","1561","47639","47","049","47049","2020"
"Census Tract 9653, Fentress County, Tennessee","802","638","477","133","2213","2050","163","1811","239","2213","43366","47","049","47049","2020"
"Census Tract 9601, Franklin County, Tennessee","559","506","186","188","1698","1439","259","1118","321","1698","39422","47","051","47051","2020"
"Census Tract 9602.01, Franklin County, Tennessee","1023","851","728","107","3154","2709","445","2209","500","3154","60107","47","051","47051","2020"
"Census Tract 9602.02, Franklin County, Tennessee","844","642","573","53","2378","2112","266","1743","369","2378","48989","47","051","47051","2020"
"Census Tract 9603, Franklin County, Tennessee","312","398","305","49","1576","1064","512","900","164","1576","68204","47","051","47051","2020"
"Census Tract 9604.01, Franklin County, Tennessee","622","892","336","72","1979","1922","57","896","1026","1979","35691","47","051","47051","2020"
"Census Tract 9604.02, Franklin County, Tennessee","495","543","482","61","1899","1581","318","1161","420","1899","58234","47","051","47051","2020"
"Census Tract 9605, Franklin County, Tennessee","601","572","262","65","1826","1500","326","972","528","1826","45260","47","051","47051","2020"
"Census Tract 9606, Franklin County, Tennessee","726","614","349","88","2231","1777","454","1277","500","2231","38094","47","051","47051","2020"
"Census Tract 9607, Franklin County, Tennessee","383","426","313","75","1434","1197","237","873","324","1434","50169","47","051","47051","2020"
"Census Tract 9608, Franklin County, Tennessee","382","409","304","101","1333","1196","137","975","221","1333","46250","47","051","47051","2020"
"Census Tract 9661, Gibson County, Tennessee","343","375","200","23","1183","941","242","699","242","1183","41406","47","053","47053","2020"
"Census Tract 9662, Gibson County, Tennessee","483","392","438","43","1536","1356","180","917","439","1536","37039","47","053","47053","2020"
"Census Tract 9663, Gibson County, Tennessee","248","415","347","46","1168","1056","112","698","358","1168","50385","47","053","47053","2020"
"Census Tract 9664, Gibson County, Tennessee","522","687","570","61","2314","1840","474","1247","593","2314","47008","47","053","47053","2020"
"Census Tract 9665.01, Gibson County, Tennessee","347","149","379","7","1106","882","224","542","340","1106","55357","47","053","47053","2020"
"Census Tract 9665.02, Gibson County, Tennessee","713","371","276","16","1538","1376","162","817","559","1538","33438","47","053","47053","2020"
"Census Tract 409.08, Rutherford County, Tennessee","270","1667","956","467","3420","3360","60","1441","1919","3420","66285","47","149","47149","2020"
"Census Tract 409.09, Rutherford County, Tennessee","146","824","913","136","2148","2019","129","1284","735","2148","76036","47","149","47149","2020"
"Census Tract 409.10, Rutherford County, Tennessee","603","879","744","193","2640","2419","221","1474","945","2640","56943","47","149","47149","2020"
"Census Tract 409.11, Rutherford County, Tennessee","337","609","678","181","1985","1805","180","1575","230","1985","103051","47","149","47149","2020"
"Census Tract 410, Rutherford County, Tennessee","312","1064","1022","379","2896","2777","119","2045","732","2896","91896","47","149","47149","2020"
"Census Tract 411.02, Rutherford County, Tennessee","376","262","461","85","1296","1184","112","906","278","1296","61977","47","149","47149","2020"
"Census Tract 411.03, Rutherford County, Tennessee","291","532","609","56","1509","1488","21","1157","331","1509","88667","47","149","47149","2020"
"Census Tract 411.04, Rutherford County, Tennessee","302","263","570","183","1331","1318","13","1234","84","1331","110750","47","149","47149","2020"
"Census Tract 412.01, Rutherford County, Tennessee","311","825","925","118","2258","2179","79","1896","283","2258","89509","47","149","47149","2020"
"Census Tract 412.02, Rutherford County, Tennessee","367","325","726","152","1652","1570","82","1429","141","1652","95776","47","149","47149","2020"
"Census Tract 413.01, Rutherford County, Tennessee","460","615","859","243","2322","2177","145","1907","270","2322","124327","47","149","47149","2020"
"Census Tract 413.02, Rutherford County, Tennessee","673","689","750","135","2378","2247","131","1543","704","2378","76113","47","149","47149","2020"
"Census Tract 414.01, Rutherford County, Tennessee","327","733","646","379","2205","2085","120","1111","974","2205","59618","47","149","47149","2020"
"Census Tract 414.04, Rutherford County, Tennessee","382","808","516","90","1966","1796","170","531","1265","1966","42404","47","149","47149","2020"
"Census Tract 414.05, Rutherford County, Tennessee","117","410","466","78","1226","1071","155","49","1022","1226","45837","47","149","47149","2020"
"Census Tract 414.06, Rutherford County, Tennessee","407","715","734","119","2112","1975","137","518","1457","2112","49782","47","149","47149","2020"
"Census Tract 414.07, Rutherford County, Tennessee","172","547","646","247","1645","1612","33","677","935","1645","55198","47","149","47149","2020"
"Census Tract 415, Rutherford County, Tennessee","0","14","0","0","14","14","0","0","14","14","-666666666","47","149","47149","2020"
"Census Tract 416.01, Rutherford County, Tennessee","86","576","323","208","1496","1193","303","202","991","1496","49809","47","149","47149","2020"
"Census Tract 416.02, Rutherford County, Tennessee","641","351","337","37","1485","1366","119","374","992","1485","39063","47","149","47149","2020"
"Census Tract 417, Rutherford County, Tennessee","377","1166","692","210","2550","2445","105","1058","1387","2550","47518","47","149","47149","2020"
"Census Tract 418, Rutherford County, Tennessee","279","821","429","77","1806","1606","200","353","1253","1806","44229","47","149","47149","2020"
"Census Tract 419, Rutherford County, Tennessee","570","684","354","109","1965","1717","248","523","1194","1965","35046","47","149","47149","2020"
"Census Tract 420, Rutherford County, Tennessee","445","1034","445","133","2200","2057","143","1312","745","2200","49310","47","149","47149","2020"
"Census Tract 421.01, Rutherford County, Tennessee","290","710","772","119","2181","1891","290","366","1525","2181","35492","47","149","47149","2020"
"Census Tract 421.02, Rutherford County, Tennessee","557","787","292","179","1975","1815","160","443","1372","1975","36737","47","149","47149","2020"
"Census Tract 422, Rutherford County, Tennessee","361","708","626","102","1817","1797","20","822","975","1817","64199","47","149","47149","2020"
"Census Tract 423.01, Rutherford County, Tennessee","268","765","511","173","1901","1717","184","971","746","1901","70991","47","149","47149","2020"
"Census Tract 423.02, Rutherford County, Tennessee","62","664","509","156","1391","1391","0","1108","283","1391","75188","47","149","47149","2020"
"Census Tract 9750, Scott County, Tennessee","622","449","363","45","1883","1479","404","1178","301","1883","34654","47","151","47151","2020"
"Census Tract 9751.01, Scott County, Tennessee","653","385","147","41","1266","1226","40","596","630","1266","21860","47","151","47151","2020"
"Census Tract 9751.02, Scott County, Tennessee","573","665","498","48","1993","1784","209","1342","442","1993","41320","47","151","47151","2020"
"Census Tract 9752, Scott County, Tennessee","890","643","480","72","2426","2085","341","1409","676","2426","40399","47","151","47151","2020"
"Census Tract 9753, Scott County, Tennessee","421","296","194","53","1119","964","155","759","205","1119","36731","47","151","47151","2020"
"Census Tract 9754, Scott County, Tennessee","414","421","224","28","1348","1087","261","868","219","1348","53281","47","151","47151","2020"
"Census Tract 601.02, Sequatchie County, Tennessee","424","224","198","32","1088","878","210","753","125","1088","43529","47","153","47153","2020"
"Census Tract 601.03, Sequatchie County, Tennessee","692","510","264","82","1823","1548","275","1071","477","1823","41176","47","153","47153","2020"
"Census Tract 601.04, Sequatchie County, Tennessee","344","761","406","90","1813","1601","212","1147","454","1813","49688","47","153","47153","2020"
"Census Tract 602, Sequatchie County, Tennessee","567","452","409","84","1791","1512","279","1260","252","1791","51357","47","153","47153","2020"
"Census Tract 801.01, Sevier County, Tennessee","337","438","427","58","1482","1260","222","854","406","1482","55407","47","155","47155","2020"
"Census Tract 801.03, Sevier County, Tennessee","366","607","339","204","1722","1516","206","1040","476","1722","57535","47","155","47155","2020"
"Census Tract 801.04, Sevier County, Tennessee","367","494","347","109","1429","1317","112","1188","129","1429","65122","47","155","47155","2020"
"Census Tract 802.02, Sevier County, Tennessee","659","726","579","207","2319","2171","148","1869","302","2319","67951","47","155","47155","2020"
"Census Tract 802.03, Sevier County, Tennessee","481","891","691","132","2418","2195","223","1957","238","2418","58878","47","155","47155","2020"
"Census Tract 802.04, Sevier County, Tennessee","290","488","420","142","1370","1340","30","1272","68","1370","70278","47","155","47155","2020"
"Census Tract 9666, Gibson County, Tennessee","181","309","217","31","748","738","10","584","154","748","52857","47","053","47053","2020"
"Census Tract 9667.01, Gibson County, Tennessee","512","133","312","69","1303","1026","277","403","623","1303","37097","47","053","47053","2020"
"Census Tract 9667.02, Gibson County, Tennessee","515","538","214","10","1387","1277","110","815","462","1387","34598","47","053","47053","2020"
"Census Tract 9668, Gibson County, Tennessee","126","173","137","31","535","467","68","396","71","535","50699","47","053","47053","2020"
"Census Tract 9669, Gibson County, Tennessee","535","271","222","42","1372","1070","302","593","477","1372","26750","47","053","47053","2020"
"Census Tract 9670.01, Gibson County, Tennessee","660","798","270","99","1995","1827","168","1013","814","1995","39107","47","053","47053","2020"
"Census Tract 9670.02, Gibson County, Tennessee","465","662","105","0","1483","1232","251","521","711","1483","28302","47","053","47053","2020"
"Census Tract 9671, Gibson County, Tennessee","351","1423","875","167","3000","2816","184","2228","588","3000","83472","47","053","47053","2020"
"Census Tract 9673, Gibson County, Tennessee","91","140","132","12","455","375","80","293","82","455","51950","47","053","47053","2020"
"Census Tract 9674, Gibson County, Tennessee","326","475","435","79","1539","1315","224","1086","229","1539","51295","47","053","47053","2020"
"Census Tract 9801, Gibson County, Tennessee","0","0","0","0","0","0","0","0","0","0","-666666666","47","053","47053","2020"
"Census Tract 9201, Giles County, Tennessee","460","494","291","125","1695","1370","325","1214","156","1695","54893","47","055","47055","2020"
"Census Tract 9202, Giles County, Tennessee","557","679","475","68","2111","1779","332","1108","671","2111","47825","47","055","47055","2020"
"Census Tract 9203.01, Giles County, Tennessee","544","738","371","114","2214","1767","447","1040","727","2214","46536","47","055","47055","2020"
"Census Tract 9203.02, Giles County, Tennessee","371","149","145","7","899","672","227","643","29","899","42935","47","055","47055","2020"
"Census Tract 9204, Giles County, Tennessee","465","497","264","61","1415","1287","128","627","660","1415","43664","47","055","47055","2020"
"Census Tract 9205, Giles County, Tennessee","627","699","435","65","2120","1826","294","1147","679","2120","51273","47","055","47055","2020"
"Census Tract 9206, Giles County, Tennessee","502","268","344","45","1342","1159","183","957","202","1342","57803","47","055","47055","2020"
"Census Tract 9207, Giles County, Tennessee","254","292","104","38","932","688","244","603","85","932","51688","47","055","47055","2020"
"Census Tract 9208, Giles County, Tennessee","461","331","312","48","1428","1152","276","902","250","1428","49085","47","055","47055","2020"
"Census Tract 5001, Grainger County, Tennessee","753","404","299","139","1938","1595","343","1385","210","1938","41520","47","057","47057","2020"
"Census Tract 5002, Grainger County, Tennessee","448","517","658","143","1947","1766","181","1348","418","1947","59254","47","057","47057","2020"
"Census Tract 5003.01, Grainger County, Tennessee","445","427","317","48","1460","1237","223","887","350","1460","41480","47","057","47057","2020"
"Census Tract 5003.02, Grainger County, Tennessee","578","681","248","0","1863","1507","356","1067","440","1863","46548","47","057","47057","2020"
"Census Tract 5004.01, Grainger County, Tennessee","438","323","218","64","1279","1043","236","747","296","1279","35779","47","057","47057","2020"
"Census Tract 5004.02, Grainger County, Tennessee","728","703","471","97","2670","1999","671","1556","443","2670","44234","47","057","47057","2020"
"Census Tract 901, Greene County, Tennessee","1080","869","342","27","2951","2318","633","1515","803","2951","30625","47","059","47059","2020"
"Census Tract 902, Greene County, Tennessee","482","214","148","24","999","868","131","602","266","999","44875","47","059","47059","2020"
"Census Tract 903, Greene County, Tennessee","965","857","487","101","2624","2410","214","1592","818","2624","43490","47","059","47059","2020"
"Census Tract 904, Greene County, Tennessee","841","840","346","100","2439","2127","312","1364","763","2439","41335","47","059","47059","2020"
"Census Tract 905.01, Greene County, Tennessee","518","784","466","120","2254","1888","366","1262","626","2254","43446","47","059","47059","2020"
"Census Tract 905.02, Greene County, Tennessee","133","271","144","44","808","592","216","492","100","808","80208","47","059","47059","2020"
"Census Tract 906, Greene County, Tennessee","689","504","369","114","1950","1676","274","1387","289","1950","45939","47","059","47059","2020"
"Census Tract 907, Greene County, Tennessee","427","401","243","43","1274","1114","160","840","274","1274","39808","47","059","47059","2020"
"Census Tract 908, Greene County, Tennessee","717","662","224","188","2224","1791","433","1574","217","2224","49366","47","059","47059","2020"
"Census Tract 909, Greene County, Tennessee","830","740","587","95","2508","2252","256","1816","436","2508","50542","47","059","47059","2020"
"Census Tract 910.01, Greene County, Tennessee","784","491","345","125","2264","1745","519","1439","306","2264","38345","47","059","47059","2020"
"Census Tract 910.02, Greene County, Tennessee","483","453","520","42","1617","1498","119","1218","280","1617","49643","47","059","47059","2020"
"Census Tract 911, Greene County, Tennessee","738","410","337","110","1851","1595","256","1350","245","1851","45562","47","059","47059","2020"
"Census Tract 912, Greene County, Tennessee","529","316","421","42","1634","1308","326","1073","235","1634","50375","47","059","47059","2020"
"Census Tract 913, Greene County, Tennessee","815","697","331","47","2295","1890","405","1360","530","2295","35938","47","059","47059","2020"
"Census Tract 914, Greene County, Tennessee","447","445","264","24","1432","1180","252","867","313","1432","40439","47","059","47059","2020"
"Census Tract 915, Greene County, Tennessee","534","373","305","51","1531","1263","268","1109","154","1531","53480","47","059","47059","2020"
"Census Tract 9550, Grundy County, Tennessee","364","307","361","35","1452","1067","385","919","148","1452","39097","47","061","47061","2020"
"Census Tract 9551, Grundy County, Tennessee","251","204","136","51","938","642","296","505","137","938","42907","47","061","47061","2020"
"Census Tract 9552, Grundy County, Tennessee","499","436","398","46","1744","1379","365","1214","165","1744","43560","47","061","47061","2020"
"Census Tract 803, Sevier County, Tennessee","614","781","724","194","2573","2313","260","1331","982","2573","66192","47","155","47155","2020"
"Census Tract 804.01, Sevier County, Tennessee","382","706","250","41","2157","1379","778","1100","279","2157","37019","47","155","47155","2020"
"Census Tract 804.02, Sevier County, Tennessee","421","477","347","64","1700","1309","391","985","324","1700","45180","47","155","47155","2020"
"Census Tract 805, Sevier County, Tennessee","801","725","668","203","3144","2397","747","1068","1329","3144","45211","47","155","47155","2020"
"Census Tract 806.01, Sevier County, Tennessee","665","575","542","112","2175","1894","281","990","904","2175","45042","47","155","47155","2020"
"Census Tract 806.03, Sevier County, Tennessee","517","572","390","33","2086","1512","574","1262","250","2086","37167","47","155","47155","2020"
"Census Tract 806.04, Sevier County, Tennessee","494","847","564","243","2461","2148","313","1532","616","2461","51719","47","155","47155","2020"
"Census Tract 807.01, Sevier County, Tennessee","602","541","398","153","2319","1694","625","1478","216","2319","62231","47","155","47155","2020"
"Census Tract 807.02, Sevier County, Tennessee","871","638","447","72","3304","2028","1276","1737","291","3304","42188","47","155","47155","2020"
"Census Tract 808.01, Sevier County, Tennessee","318","385","202","32","1656","937","719","350","587","1656","24817","47","155","47155","2020"
"Census Tract 808.03, Sevier County, Tennessee","387","709","664","128","2077","1888","189","1470","418","2077","56867","47","155","47155","2020"
"Census Tract 808.04, Sevier County, Tennessee","207","634","231","40","1180","1112","68","464","648","1180","36532","47","155","47155","2020"
"Census Tract 809.01, Sevier County, Tennessee","383","475","447","100","3667","1405","2262","972","433","3667","58313","47","155","47155","2020"
"Census Tract 809.03, Sevier County, Tennessee","408","273","254","32","1863","967","896","877","90","1863","58433","47","155","47155","2020"
"Census Tract 809.04, Sevier County, Tennessee","272","189","271","103","2174","835","1339","566","269","2174","48586","47","155","47155","2020"
"Census Tract 810.01, Sevier County, Tennessee","146","454","503","98","2933","1201","1732","669","532","2933","64440","47","155","47155","2020"
"Census Tract 810.02, Sevier County, Tennessee","203","280","559","47","2299","1089","1210","535","554","2299","47670","47","155","47155","2020"
"Census Tract 811.01, Sevier County, Tennessee","214","222","192","14","3271","642","2629","367","275","3271","38833","47","155","47155","2020"
"Census Tract 811.03, Sevier County, Tennessee","374","290","128","78","1929","870","1059","689","181","1929","41705","47","155","47155","2020"
"Census Tract 811.04, Sevier County, Tennessee","183","231","138","15","2446","567","1879","376","191","2446","42788","47","155","47155","2020"
"Census Tract 9801, Sevier County, Tennessee","0","7","0","0","7","7","0","7","0","7","-666666666","47","155","47155","2020"
"Census Tract 1, Shelby County, Tennessee","419","1943","764","19","3442","3145","297","1088","2057","3442","72841","47","157","47157","2020"
"Census Tract 2, Shelby County, Tennessee","204","186","23","0","523","413","110","108","305","523","21250","47","157","47157","2020"
"Census Tract 3, Shelby County, Tennessee","101","177","10","0","421","288","133","124","164","421","19310","47","157","47157","2020"
"Census Tract 4, Shelby County, Tennessee","242","252","63","0","785","557","228","160","397","785","29961","47","157","47157","2020"
"Census Tract 6, Shelby County, Tennessee","349","304","75","0","1072","728","344","303","425","1072","17546","47","157","47157","2020"
"Census Tract 7, Shelby County, Tennessee","897","844","182","36","2525","1959","566","842","1117","2525","19363","47","157","47157","2020"
"Census Tract 8, Shelby County, Tennessee","430","459","45","0","1053","934","119","280","654","1053","17045","47","157","47157","2020"
"Census Tract 9, Shelby County, Tennessee","575","292","193","60","1348","1120","228","530","590","1348","24000","47","157","47157","2020"
"Census Tract 11, Shelby County, Tennessee","277","469","267","74","1407","1087","320","454","633","1407","38363","47","157","47157","2020"
"Census Tract 12, Shelby County, Tennessee","338","602","407","57","1590","1404","186","710","694","1590","37145","47","157","47157","2020"
"Census Tract 13, Shelby County, Tennessee","389","528","105","10","1542","1032","510","516","516","1542","23586","47","157","47157","2020"
"Census Tract 14, Shelby County, Tennessee","155","320","75","56","711","606","105","191","415","711","29914","47","157","47157","2020"
"Census Tract 15, Shelby County, Tennessee","268","308","102","37","893","715","178","466","249","893","32015","47","157","47157","2020"
"Census Tract 16, Shelby County, Tennessee","338","286","287","25","1044","936","108","636","300","1044","74167","47","157","47157","2020"
"Census Tract 17, Shelby County, Tennessee","420","742","707","32","2171","1901","270","1027","874","2171","61622","47","157","47157","2020"
"Census Tract 19, Shelby County, Tennessee","174","166","135","19","691","494","197","218","276","691","-666666666","47","157","47157","2020"
"Census Tract 20, Shelby County, Tennessee","172","469","46","0","797","687","110","230","457","797","31776","47","157","47157","2020"
"Census Tract 21, Shelby County, Tennessee","192","395","123","9","781","719","62","166","553","781","36688","47","157","47157","2020"
"Census Tract 24, Shelby County, Tennessee","305","523","55","23","1255","906","349","153","753","1255","21037","47","157","47157","2020"
"Census Tract 25, Shelby County, Tennessee","419","468","279","46","1512","1212","300","439","773","1512","28462","47","157","47157","2020"
"Census Tract 26, Shelby County, Tennessee","162","475","527","39","1369","1203","166","705","498","1369","100804","47","157","47157","2020"
"Census Tract 27, Shelby County, Tennessee","206","328","155","79","880","768","112","417","351","880","40781","47","157","47157","2020"
"Census Tract 28, Shelby County, Tennessee","933","500","130","0","1788","1563","225","642","921","1788","15405","47","157","47157","2020"
"Census Tract 29, Shelby County, Tennessee","531","1013","594","55","2510","2193","317","1810","383","2510","99514","47","157","47157","2020"
"Census Tract 30, Shelby County, Tennessee","808","346","174","80","1687","1408","279","567","841","1687","24794","47","157","47157","2020"
"Census Tract 9553, Grundy County, Tennessee","614","621","562","59","2333","1856","477","1247","609","2333","44054","47","061","47061","2020"
"Census Tract 1001, Hamblen County, Tennessee","993","1017","442","67","2755","2519","236","1162","1357","2755","27329","47","063","47063","2020"
"Census Tract 1002, Hamblen County, Tennessee","872","1054","290","100","2612","2316","296","1383","933","2612","36944","47","063","47063","2020"
"Census Tract 1003, Hamblen County, Tennessee","579","458","202","0","1409","1239","170","438","801","1409","19531","47","063","47063","2020"
"Census Tract 1004, Hamblen County, Tennessee","771","1044","299","185","2555","2299","256","1291","1008","2555","39797","47","063","47063","2020"
"Census Tract 1005, Hamblen County, Tennessee","606","385","246","73","1542","1310","232","1028","282","1542","48500","47","063","47063","2020"
"Census Tract 1006, Hamblen County, Tennessee","971","1211","613","213","3307","3008","299","2004","1004","3307","52537","47","063","47063","2020"
"Census Tract 1007, Hamblen County, Tennessee","758","579","626","163","2453","2126","327","1931","195","2453","53910","47","063","47063","2020"
"Census Tract 1008, Hamblen County, Tennessee","431","494","261","62","1406","1248","158","753","495","1406","32400","47","063","47063","2020"
"Census Tract 1009, Hamblen County, Tennessee","536","797","625","143","2281","2101","180","1304","797","2281","62321","47","063","47063","2020"
"Census Tract 1010, Hamblen County, Tennessee","888","555","562","80","2257","2085","172","1550","535","2257","39558","47","063","47063","2020"
"Census Tract 1011, Hamblen County, Tennessee","547","667","586","162","2158","1962","196","1692","270","2158","74542","47","063","47063","2020"
"Census Tract 1012, Hamblen County, Tennessee","635","770","754","118","2505","2277","228","1813","464","2505","56674","47","063","47063","2020"
"Census Tract 4, Hamilton County, Tennessee","594","761","105","39","1765","1499","266","669","830","1765","23048","47","065","47065","2020"
"Census Tract 6, Hamilton County, Tennessee","373","783","438","45","1980","1639","341","1070","569","1980","81367","47","065","47065","2020"
"Census Tract 7, Hamilton County, Tennessee","156","1001","851","71","2178","2079","99","1293","786","2178","94107","47","065","47065","2020"
"Census Tract 8, Hamilton County, Tennessee","395","357","254","11","1139","1017","122","395","622","1139","39866","47","065","47065","2020"
"Census Tract 11, Hamilton County, Tennessee","280","213","141","60","891","694","197","363","331","891","38800","47","065","47065","2020"
"Census Tract 12, Hamilton County, Tennessee","657","448","273","12","1617","1390","227","474","916","1617","31212","47","065","47065","2020"
"Census Tract 13, Hamilton County, Tennessee","331","297","150","40","933","818","115","298","520","933","22059","47","065","47065","2020"
"Census Tract 14, Hamilton County, Tennessee","151","223","261","28","811","663","148","295","368","811","44934","47","065","47065","2020"
"Census Tract 16, Hamilton County, Tennessee","1115","431","53","0","1964","1599","365","165","1434","1964","15526","47","065","47065","2020"
"Census Tract 18, Hamilton County, Tennessee","342","528","279","29","1437","1178","259","809","369","1437","53509","47","065","47065","2020"
"Census Tract 19, Hamilton County, Tennessee","653","718","182","29","2046","1582","464","536","1046","2046","23922","47","065","47065","2020"
"Census Tract 20, Hamilton County, Tennessee","219","273","259","25","924","776","148","288","488","924","67000","47","065","47065","2020"
"Census Tract 23, Hamilton County, Tennessee","167","181","132","24","596","504","92","210","294","596","36154","47","065","47065","2020"
"Census Tract 24, Hamilton County, Tennessee","797","645","188","72","1850","1702","148","714","988","1850","30427","47","065","47065","2020"
"Census Tract 25, Hamilton County, Tennessee","804","764","244","98","2136","1910","226","601","1309","2136","22675","47","065","47065","2020"
"Census Tract 26, Hamilton County, Tennessee","281","322","123","48","913","774","139","331","443","913","30081","47","065","47065","2020"
"Census Tract 28, Hamilton County, Tennessee","575","619","422","129","2022","1745","277","1130","615","2022","58076","47","065","47065","2020"
"Census Tract 29, Hamilton County, Tennessee","249","648","269","9","1366","1175","191","585","590","1366","39384","47","065","47065","2020"
"Census Tract 30, Hamilton County, Tennessee","204","614","140","7","1075","965","110","495","470","1075","40742","47","065","47065","2020"
"Census Tract 31, Hamilton County, Tennessee","248","575","155","33","1231","1011","220","200","811","1231","66420","47","065","47065","2020"
"Census Tract 32, Hamilton County, Tennessee","546","568","250","0","1654","1364","290","985","379","1654","37340","47","065","47065","2020"
"Census Tract 33, Hamilton County, Tennessee","791","1087","620","98","2928","2596","332","1562","1034","2928","41020","47","065","47065","2020"
"Census Tract 34, Hamilton County, Tennessee","405","1135","360","104","2195","2004","191","714","1290","2195","37526","47","065","47065","2020"
"Census Tract 101.01, Hamilton County, Tennessee","519","792","935","173","2524","2419","105","2084","335","2524","74385","47","065","47065","2020"
"Census Tract 101.03, Hamilton County, Tennessee","413","599","466","30","1645","1508","137","1327","181","1645","71964","47","065","47065","2020"
"Census Tract 101.04, Hamilton County, Tennessee","456","443","504","47","1730","1450","280","1270","180","1730","64667","47","065","47065","2020"
"Census Tract 102.01, Hamilton County, Tennessee","669","424","373","137","1694","1603","91","1534","69","1694","70139","47","065","47065","2020"
"Census Tract 102.02, Hamilton County, Tennessee","611","547","396","110","1788","1664","124","1411","253","1788","53026","47","065","47065","2020"
"Census Tract 103.03, Hamilton County, Tennessee","236","544","320","73","1231","1173","58","1063","110","1231","68381","47","065","47065","2020"
"Census Tract 103.04, Hamilton County, Tennessee","516","558","814","99","2236","1987","249","1747","240","2236","75950","47","065","47065","2020"
"Census Tract 103.05, Hamilton County, Tennessee","306","443","394","87","1344","1230","114","1064","166","1344","73600","47","065","47065","2020"
"Census Tract 103.06, Hamilton County, Tennessee","469","585","474","84","1612","1612","0","1175","437","1612","50410","47","065","47065","2020"
"Census Tract 31, Shelby County, Tennessee","287","979","441","22","1937","1729","208","829","900","1937","50784","47","157","47157","2020"
"Census Tract 32, Shelby County, Tennessee","698","1024","329","47","2372","2098","274","579","1519","2372","40993","47","157","47157","2020"
"Census Tract 33, Shelby County, Tennessee","247","599","377","21","1341","1244","97","999","245","1341","97083","47","157","47157","2020"
"Census Tract 34, Shelby County, Tennessee","147","872","241","43","1507","1303","204","287","1016","1507","34840","47","157","47157","2020"
"Census Tract 35, Shelby County, Tennessee","373","639","660","19","1922","1691","231","993","698","1922","82723","47","157","47157","2020"
"Census Tract 36, Shelby County, Tennessee","292","551","121","21","1238","985","253","153","832","1238","31250","47","157","47157","2020"
"Census Tract 37, Shelby County, Tennessee","469","262","76","0","964","807","157","0","807","964","14548","47","157","47157","2020"
"Census Tract 38, Shelby County, Tennessee","324","179","5","0","586","508","78","0","508","586","11410","47","157","47157","2020"
"Census Tract 39, Shelby County, Tennessee","652","391","110","6","1274","1159","115","5","1154","1274","14484","47","157","47157","2020"
"Census Tract 42, Shelby County, Tennessee","304","1303","516","47","2586","2170","416","688","1482","2586","75968","47","157","47157","2020"
"Census Tract 43, Shelby County, Tennessee","301","1087","453","19","2037","1860","177","740","1120","2037","84417","47","157","47157","2020"
"Census Tract 45, Shelby County, Tennessee","227","181","29","0","480","437","43","55","382","480","15598","47","157","47157","2020"
"Census Tract 46, Shelby County, Tennessee","491","168","59","14","859","732","127","257","475","859","22782","47","157","47157","2020"
"Census Tract 50, Shelby County, Tennessee","265","67","28","0","427","360","67","39","321","427","14516","47","157","47157","2020"
"Census Tract 53, Shelby County, Tennessee","563","622","55","37","1794","1277","517","521","756","1794","20085","47","157","47157","2020"
"Census Tract 55, Shelby County, Tennessee","440","388","38","8","1377","874","503","344","530","1377","20231","47","157","47157","2020"
"Census Tract 56, Shelby County, Tennessee","503","876","86","95","1857","1560","297","849","711","1857","27240","47","157","47157","2020"
"Census Tract 57, Shelby County, Tennessee","256","390","201","18","1135","865","270","307","558","1135","32785","47","157","47157","2020"
"Census Tract 58, Shelby County, Tennessee","134","129","25","15","501","303","198","82","221","501","22399","47","157","47157","2020"
"Census Tract 59, Shelby County, Tennessee","308","314","21","6","973","649","324","359","290","973","25986","47","157","47157","2020"
"Census Tract 60, Shelby County, Tennessee","435","270","74","8","954","787","167","346","441","954","23477","47","157","47157","2020"
"Census Tract 62, Shelby County, Tennessee","379","212","70","22","1017","683","334","418","265","1017","25417","47","157","47157","2020"
"Census Tract 63, Shelby County, Tennessee","219","581","345","103","1330","1248","82","636","612","1330","62302","47","157","47157","2020"
"Census Tract 64, Shelby County, Tennessee","161","345","189","45","807","740","67","442","298","807","43426","47","157","47157","2020"
"Census Tract 65, Shelby County, Tennessee","415","402","223","25","1233","1065","168","312","753","1233","23173","47","157","47157","2020"
"Census Tract 66, Shelby County, Tennessee","298","845","153","46","1499","1342","157","357","985","1499","38684","47","157","47157","2020"
"Census Tract 67, Shelby County, Tennessee","373","600","205","9","1596","1187","409","351","836","1596","28159","47","157","47157","2020"
"Census Tract 68, Shelby County, Tennessee","328","390","105","28","1166","851","315","447","404","1166","28144","47","157","47157","2020"
"Census Tract 69, Shelby County, Tennessee","487","343","117","20","1197","967","230","477","490","1197","25144","47","157","47157","2020"
"Census Tract 70, Shelby County, Tennessee","467","546","239","18","1707","1270","437","311","959","1707","23115","47","157","47157","2020"
"Census Tract 71, Shelby County, Tennessee","133","470","459","32","1256","1094","162","906","188","1256","109280","47","157","47157","2020"
"Census Tract 72, Shelby County, Tennessee","191","891","492","20","1693","1594","99","932","662","1693","76111","47","157","47157","2020"
"Census Tract 73, Shelby County, Tennessee","742","552","238","19","1828","1551","277","299","1252","1828","25795","47","157","47157","2020"
"Census Tract 74, Shelby County, Tennessee","325","630","299","41","1504","1295","209","355","940","1504","31911","47","157","47157","2020"
"Census Tract 75, Shelby County, Tennessee","237","306","40","0","721","583","138","327","256","721","27064","47","157","47157","2020"
"Census Tract 78.10, Shelby County, Tennessee","610","374","10","0","1524","994","530","399","595","1524","14832","47","157","47157","2020"
"Census Tract 78.21, Shelby County, Tennessee","956","740","490","72","3024","2258","766","856","1402","3024","36929","47","157","47157","2020"
"Census Tract 78.22, Shelby County, Tennessee","309","237","47","0","680","593","87","367","226","680","26188","47","157","47157","2020"
"Census Tract 79, Shelby County, Tennessee","1066","864","295","32","2728","2257","471","832","1425","2728","25678","47","157","47157","2020"
"Census Tract 80, Shelby County, Tennessee","785","959","268","51","2255","2063","192","811","1252","2255","29233","47","157","47157","2020"
"Census Tract 81.10, Shelby County, Tennessee","432","235","142","16","1292","825","467","263","562","1292","18368","47","157","47157","2020"
"Census Tract 81.20, Shelby County, Tennessee","944","924","321","0","2566","2189","377","991","1198","2566","22132","47","157","47157","2020"
"Census Tract 82, Shelby County, Tennessee","628","818","247","67","2181","1760","421","573","1187","2181","27727","47","157","47157","2020"
"Census Tract 85, Shelby County, Tennessee","597","660","569","23","1957","1849","108","1415","434","1957","125795","47","157","47157","2020"
"Census Tract 86, Shelby County, Tennessee","430","894","977","152","2775","2453","322","1756","697","2775","107941","47","157","47157","2020"
"Census Tract 87, Shelby County, Tennessee","614","804","514","112","2123","2044","79","1082","962","2123","39200","47","157","47157","2020"
"Census Tract 103.08, Hamilton County, Tennessee","389","467","272","5","1303","1133","170","823","310","1303","49950","47","065","47065","2020"
"Census Tract 103.09, Hamilton County, Tennessee","599","532","229","10","1531","1370","161","1006","364","1531","46378","47","065","47065","2020"
"Census Tract 104.11, Hamilton County, Tennessee","747","785","885","402","2904","2819","85","2399","420","2904","85888","47","065","47065","2020"
"Census Tract 104.12, Hamilton County, Tennessee","520","628","550","116","1893","1814","79","1508","306","1893","58200","47","065","47065","2020"
"Census Tract 104.13, Hamilton County, Tennessee","282","479","613","92","1552","1466","86","1271","195","1552","89167","47","065","47065","2020"
"Census Tract 104.31, Hamilton County, Tennessee","997","1023","675","215","3222","2910","312","2102","808","3222","61861","47","065","47065","2020"
"Census Tract 104.32, Hamilton County, Tennessee","927","1167","812","113","3245","3019","226","2332","687","3245","71748","47","065","47065","2020"
"Census Tract 104.33, Hamilton County, Tennessee","498","958","740","93","2448","2289","159","1439","850","2448","52566","47","065","47065","2020"
"Census Tract 104.34, Hamilton County, Tennessee","264","298","230","68","999","860","139","659","201","999","70938","47","065","47065","2020"
"Census Tract 104.35, Hamilton County, Tennessee","986","573","496","138","2492","2193","299","1540","653","2492","41970","47","065","47065","2020"
"Census Tract 105.01, Hamilton County, Tennessee","715","830","982","140","2887","2667","220","1895","772","2887","54336","47","065","47065","2020"
"Census Tract 105.02, Hamilton County, Tennessee","446","514","465","46","1695","1471","224","1005","466","1695","66325","47","065","47065","2020"
"Census Tract 106, Hamilton County, Tennessee","461","635","411","37","1626","1544","82","1141","403","1626","50739","47","065","47065","2020"
"Census Tract 107, Hamilton County, Tennessee","438","705","373","15","1682","1531","151","646","885","1682","43516","47","065","47065","2020"
"Census Tract 108, Hamilton County, Tennessee","577","972","418","38","2354","2005","349","977","1028","2354","40518","47","065","47065","2020"
"Census Tract 109.01, Hamilton County, Tennessee","181","549","423","8","1299","1161","138","298","863","1299","54815","47","065","47065","2020"
"Census Tract 109.02, Hamilton County, Tennessee","168","132","82","6","447","388","59","222","166","447","45395","47","065","47065","2020"
"Census Tract 109.04, Hamilton County, Tennessee","485","242","495","66","1365","1288","77","505","783","1365","60710","47","065","47065","2020"
"Census Tract 109.05, Hamilton County, Tennessee","774","730","409","36","2218","1949","269","816","1133","2218","47662","47","065","47065","2020"
"Census Tract 110.01, Hamilton County, Tennessee","282","294","159","30","881","765","116","699","66","881","61023","47","065","47065","2020"
"Census Tract 110.03, Hamilton County, Tennessee","316","489","431","36","1377","1272","105","1172","100","1377","113039","47","065","47065","2020"
"Census Tract 110.04, Hamilton County, Tennessee","396","558","372","59","1461","1385","76","1155","230","1461","107078","47","065","47065","2020"
"Census Tract 111, Hamilton County, Tennessee","937","562","813","83","2523","2395","128","2099","296","2523","107847","47","065","47065","2020"
"Census Tract 112.03, Hamilton County, Tennessee","396","565","726","227","2145","1914","231","1420","494","2145","90306","47","065","47065","2020"
"Census Tract 112.04, Hamilton County, Tennessee","624","833","677","64","2431","2198","233","1777","421","2431","46641","47","065","47065","2020"
"Census Tract 112.05, Hamilton County, Tennessee","569","998","857","106","2816","2530","286","2378","152","2816","106623","47","065","47065","2020"
"Census Tract 112.06, Hamilton County, Tennessee","819","868","427","60","2332","2174","158","1138","1036","2332","53898","47","065","47065","2020"
"Census Tract 113.11, Hamilton County, Tennessee","947","1573","974","237","3958","3731","227","1783","1948","3958","65560","47","065","47065","2020"
"Census Tract 113.14, Hamilton County, Tennessee","533","725","532","176","2035","1966","69","1685","281","2035","84286","47","065","47065","2020"
"Census Tract 113.21, Hamilton County, Tennessee","655","1278","974","214","3406","3121","285","1894","1227","3406","77022","47","065","47065","2020"
"Census Tract 113.23, Hamilton County, Tennessee","794","909","691","140","2923","2534","389","1842","692","2923","77994","47","065","47065","2020"
"Census Tract 113.24, Hamilton County, Tennessee","249","515","737","82","1620","1583","37","1504","79","1620","141017","47","065","47065","2020"
"Census Tract 113.25, Hamilton County, Tennessee","514","826","671","163","2426","2174","252","1956","218","2426","94321","47","065","47065","2020"
"Census Tract 113.26, Hamilton County, Tennessee","325","1318","655","366","2797","2664","133","1059","1605","2797","50725","47","065","47065","2020"
"Census Tract 114.02, Hamilton County, Tennessee","826","1033","554","90","2547","2503","44","1440","1063","2547","46428","47","065","47065","2020"
"Census Tract 114.11, Hamilton County, Tennessee","419","810","433","119","1930","1781","149","953","828","1930","46569","47","065","47065","2020"
"Census Tract 114.13, Hamilton County, Tennessee","805","1263","1026","304","3506","3398","108","2532","866","3506","67386","47","065","47065","2020"
"Census Tract 114.42, Hamilton County, Tennessee","302","564","198","86","1229","1150","79","733","417","1229","42372","47","065","47065","2020"
"Census Tract 114.44, Hamilton County, Tennessee","723","587","132","103","1727","1545","182","947","598","1727","35998","47","065","47065","2020"
"Census Tract 114.45, Hamilton County, Tennessee","587","901","449","24","2128","1961","167","869","1092","2128","46899","47","065","47065","2020"
"Census Tract 114.46, Hamilton County, Tennessee","411","754","718","162","2217","2045","172","980","1065","2217","65801","47","065","47065","2020"
"Census Tract 114.47, Hamilton County, Tennessee","607","947","1246","211","3147","3011","136","2701","310","3147","88268","47","065","47065","2020"
"Census Tract 114.48, Hamilton County, Tennessee","624","830","602","0","2251","2056","195","598","1458","2251","44561","47","065","47065","2020"
"Census Tract 114.49, Hamilton County, Tennessee","441","495","140","7","1145","1083","62","836","247","1145","52147","47","065","47065","2020"
"Census Tract 116, Hamilton County, Tennessee","809","1035","705","72","2791","2621","170","1120","1501","2791","40965","47","065","47065","2020"
"Census Tract 88, Shelby County, Tennessee","439","812","659","117","2437","2027","410","859","1168","2437","38191","47","157","47157","2020"
"Census Tract 89, Shelby County, Tennessee","292","594","326","48","1615","1260","355","572","688","1615","28056","47","157","47157","2020"
"Census Tract 91, Shelby County, Tennessee","287","444","210","21","1007","962","45","370","592","1007","29750","47","157","47157","2020"
"Census Tract 92.01, Shelby County, Tennessee","192","728","433","79","1559","1432","127","1357","75","1559","104630","47","157","47157","2020"
"Census Tract 92.02, Shelby County, Tennessee","401","560","548","163","1724","1672","52","1220","452","1724","80179","47","157","47157","2020"
"Census Tract 93, Shelby County, Tennessee","684","649","616","29","2254","1978","276","1451","527","2254","52388","47","157","47157","2020"
"Census Tract 94, Shelby County, Tennessee","392","723","468","65","1765","1648","117","1168","480","1765","64649","47","157","47157","2020"
"Census Tract 95.01, Shelby County, Tennessee","311","543","387","99","1419","1340","79","946","394","1419","54590","47","157","47157","2020"
"Census Tract 95.02, Shelby County, Tennessee","296","656","356","32","1530","1340","190","1215","125","1530","82845","47","157","47157","2020"
"Census Tract 96, Shelby County, Tennessee","514","496","840","151","2207","2001","206","1806","195","2207","136125","47","157","47157","2020"
"Census Tract 97, Shelby County, Tennessee","368","460","149","73","1203","1050","153","519","531","1203","35556","47","157","47157","2020"
"Census Tract 98, Shelby County, Tennessee","336","329","306","35","1197","1006","191","590","416","1197","41991","47","157","47157","2020"
"Census Tract 99.01, Shelby County, Tennessee","330","608","163","26","1328","1127","201","576","551","1328","35037","47","157","47157","2020"
"Census Tract 99.02, Shelby County, Tennessee","317","450","101","0","1313","868","445","311","557","1313","19353","47","157","47157","2020"
"Census Tract 100.01, Shelby County, Tennessee","407","769","160","36","1527","1372","155","734","638","1527","27083","47","157","47157","2020"
"Census Tract 100.02, Shelby County, Tennessee","486","620","178","0","1434","1284","150","456","828","1434","30308","47","157","47157","2020"
"Census Tract 101.20, Shelby County, Tennessee","806","546","310","82","2428","1744","684","451","1293","2428","23481","47","157","47157","2020"
"Census Tract 101.21, Shelby County, Tennessee","306","355","81","43","1469","785","684","306","479","1469","16696","47","157","47157","2020"
"Census Tract 101.22, Shelby County, Tennessee","253","389","53","119","1673","814","859","344","470","1673","-666666666","47","157","47157","2020"
"Census Tract 102.10, Shelby County, Tennessee","352","1025","485","66","2358","1928","430","812","1116","2358","41125","47","157","47157","2020"
"Census Tract 102.20, Shelby County, Tennessee","1052","896","649","169","2895","2766","129","1654","1112","2895","38462","47","157","47157","2020"
"Census Tract 103, Shelby County, Tennessee","219","210","69","43","714","541","173","217","324","714","20125","47","157","47157","2020"
"Census Tract 105, Shelby County, Tennessee","296","237","64","19","1377","616","761","144","472","1377","20556","47","157","47157","2020"
"Census Tract 106.10, Shelby County, Tennessee","435","1066","329","132","2391","1962","429","733","1229","2391","30600","47","157","47157","2020"
"Census Tract 106.20, Shelby County, Tennessee","308","601","278","62","1606","1249","357","288","961","1606","31165","47","157","47157","2020"
"Census Tract 106.30, Shelby County, Tennessee","437","611","205","23","1855","1276","579","275","1001","1855","26198","47","157","47157","2020"
"Census Tract 107.10, Shelby County, Tennessee","459","519","263","141","1476","1382","94","806","576","1476","42901","47","157","47157","2020"
"Census Tract 107.20, Shelby County, Tennessee","279","775","368","67","1654","1489","165","484","1005","1654","33695","47","157","47157","2020"
"Census Tract 108.10, Shelby County, Tennessee","335","830","643","236","2347","2044","303","837","1207","2347","41690","47","157","47157","2020"
"Census Tract 108.20, Shelby County, Tennessee","443","729","435","63","1832","1670","162","1207","463","1832","46792","47","157","47157","2020"
"Census Tract 110.10, Shelby County, Tennessee","255","595","359","68","1505","1277","228","916","361","1505","44716","47","157","47157","2020"
"Census Tract 110.20, Shelby County, Tennessee","150","327","92","25","1031","594","437","314","280","1031","39118","47","157","47157","2020"
"Census Tract 111, Shelby County, Tennessee","450","252","48","6","955","756","199","302","454","955","16355","47","157","47157","2020"
"Census Tract 112, Shelby County, Tennessee","392","108","65","4","856","569","287","170","399","856","13547","47","157","47157","2020"
"Census Tract 113, Shelby County, Tennessee","305","317","83","15","917","720","197","133","587","917","21136","47","157","47157","2020"
"Census Tract 114.01, Shelby County, Tennessee","275","230","0","0","596","505","91","14","491","596","12038","47","157","47157","2020"
"Census Tract 114.02, Shelby County, Tennessee","557","241","137","0","1129","935","194","26","909","1129","15433","47","157","47157","2020"
"Census Tract 115, Shelby County, Tennessee","434","418","73","0","1321","925","396","288","637","1321","25551","47","157","47157","2020"
"Census Tract 116, Shelby County, Tennessee","433","318","87","0","1145","838","307","173","665","1145","14239","47","157","47157","2020"
"Census Tract 117, Shelby County, Tennessee","185","219","20","3","544","427","117","220","207","544","29659","47","157","47157","2020"
"Census Tract 118, Shelby County, Tennessee","410","817","513","208","2228","1948","280","957","991","2228","54016","47","157","47157","2020"
"Census Tract 201.01, Shelby County, Tennessee","370","550","275","35","1536","1230","306","780","450","1536","47866","47","157","47157","2020"
"Census Tract 201.02, Shelby County, Tennessee","320","398","268","101","1135","1087","48","899","188","1135","73694","47","157","47157","2020"
"Census Tract 202.10, Shelby County, Tennessee","517","1091","487","115","2353","2210","143","1443","767","2353","44870","47","157","47157","2020"
"Census Tract 202.21, Shelby County, Tennessee","294","285","305","63","1009","947","62","774","173","1009","50335","47","157","47157","2020"
"Census Tract 202.22, Shelby County, Tennessee","201","359","147","132","941","839","102","582","257","941","52550","47","157","47157","2020"
"Census Tract 117, Hamilton County, Tennessee","450","651","707","70","2152","1878","274","1234","644","2152","55779","47","065","47065","2020"
"Census Tract 118, Hamilton County, Tennessee","653","1135","998","88","3021","2874","147","1835","1039","3021","50727","47","065","47065","2020"
"Census Tract 119, Hamilton County, Tennessee","187","335","157","25","886","704","182","434","270","886","45490","47","065","47065","2020"
"Census Tract 120, Hamilton County, Tennessee","229","253","249","23","837","754","83","723","31","837","137368","47","065","47065","2020"
"Census Tract 121, Hamilton County, Tennessee","608","1240","835","104","3143","2787","356","2074","713","3143","62958","47","065","47065","2020"
"Census Tract 122, Hamilton County, Tennessee","470","348","158","42","1047","1018","29","309","709","1047","25244","47","065","47065","2020"
"Census Tract 123, Hamilton County, Tennessee","607","1048","356","65","2361","2076","285","1347","729","2361","34251","47","065","47065","2020"
"Census Tract 124, Hamilton County, Tennessee","361","757","266","54","1792","1438","354","343","1095","1792","45809","47","065","47065","2020"
"Census Tract 9801, Hamilton County, Tennessee","0","0","0","0","0","0","0","0","0","0","-666666666","47","065","47065","2020"
"Census Tract 9802, Hamilton County, Tennessee","0","0","0","0","0","0","0","0","0","0","-666666666","47","065","47065","2020"
"Census Tract 9605, Hancock County, Tennessee","480","346","150","24","1535","1000","535","943","57","1535","34778","47","067","47067","2020"
"Census Tract 9606, Hancock County, Tennessee","897","483","308","43","2074","1731","343","1173","558","2074","26118","47","067","47067","2020"
"Census Tract 9501, Hardeman County, Tennessee","491","546","372","66","1861","1475","386","1133","342","1861","41723","47","069","47069","2020"
"Census Tract 9502, Hardeman County, Tennessee","312","459","165","24","1196","960","236","636","324","1196","37500","47","069","47069","2020"
"Census Tract 9503, Hardeman County, Tennessee","620","841","238","7","1935","1706","229","896","810","1935","34899","47","069","47069","2020"
"Census Tract 9504, Hardeman County, Tennessee","893","786","401","40","2567","2120","447","1492","628","2567","41707","47","069","47069","2020"
"Census Tract 9505, Hardeman County, Tennessee","796","492","560","46","2142","1894","248","1453","441","2142","43922","47","069","47069","2020"
"Census Tract 9506, Hardeman County, Tennessee","533","391","142","24","1322","1090","232","804","286","1322","35719","47","069","47069","2020"
"Census Tract 9201, Hardin County, Tennessee","440","672","311","95","2030","1518","512","1306","212","2030","51469","47","071","47071","2020"
"Census Tract 9202, Hardin County, Tennessee","837","621","367","39","2616","1864","752","1541","323","2616","40263","47","071","47071","2020"
"Census Tract 9203, Hardin County, Tennessee","536","650","232","66","1609","1484","125","1094","390","1609","39098","47","071","47071","2020"
"Census Tract 9204.01, Hardin County, Tennessee","328","124","221","8","888","681","207","339","342","888","39464","47","071","47071","2020"
"Census Tract 9204.02, Hardin County, Tennessee","253","578","189","0","1317","1020","297","508","512","1317","38991","47","071","47071","2020"
"Census Tract 9205.01, Hardin County, Tennessee","585","432","367","99","1813","1483","330","1200","283","1813","46188","47","071","47071","2020"
"Census Tract 9205.02, Hardin County, Tennessee","155","200","146","26","1099","527","572","393","134","1099","37250","47","071","47071","2020"
"Census Tract 9206, Hardin County, Tennessee","661","571","278","0","2737","1510","1227","1277","233","2737","40828","47","071","47071","2020"
"Census Tract 501, Hawkins County, Tennessee","815","738","293","14","2357","1860","497","1604","256","2357","35169","47","073","47073","2020"
"Census Tract 502, Hawkins County, Tennessee","647","576","352","94","2239","1669","570","1577","92","2239","50554","47","073","47073","2020"
"Census Tract 503.01, Hawkins County, Tennessee","712","488","392","83","2079","1675","404","902","773","2079","45651","47","073","47073","2020"
"Census Tract 503.02, Hawkins County, Tennessee","605","568","194","86","1763","1453","310","989","464","1763","41182","47","073","47073","2020"
"Census Tract 504, Hawkins County, Tennessee","914","940","451","89","2812","2394","418","1826","568","2812","35090","47","073","47073","2020"
"Census Tract 505.01, Hawkins County, Tennessee","767","574","269","36","2044","1646","398","1321","325","2044","39167","47","073","47073","2020"
"Census Tract 505.02, Hawkins County, Tennessee","598","344","330","7","1544","1279","265","980","299","1544","45350","47","073","47073","2020"
"Census Tract 505.03, Hawkins County, Tennessee","775","755","471","99","2278","2100","178","1590","510","2278","64375","47","073","47073","2020"
"Census Tract 506.01, Hawkins County, Tennessee","841","1080","429","165","2759","2515","244","1474","1041","2759","45750","47","073","47073","2020"
"Census Tract 506.02, Hawkins County, Tennessee","822","526","415","80","1907","1843","64","1555","288","1907","65795","47","073","47073","2020"
"Census Tract 507, Hawkins County, Tennessee","474","412","433","55","1780","1374","406","1112","262","1780","54663","47","073","47073","2020"
"Census Tract 508, Hawkins County, Tennessee","956","628","501","105","2395","2190","205","1881","309","2395","44595","47","073","47073","2020"
"Census Tract 509, Hawkins County, Tennessee","550","445","162","28","1449","1185","264","921","264","1449","35325","47","073","47073","2020"
"Census Tract 9301, Haywood County, Tennessee","263","362","348","16","1162","989","173","706","283","1162","45841","47","075","47075","2020"
"Census Tract 9302, Haywood County, Tennessee","232","182","112","28","730","554","176","403","151","730","42500","47","075","47075","2020"
"Census Tract 9303.01, Haywood County, Tennessee","527","705","405","40","1889","1677","212","1028","649","1889","41086","47","075","47075","2020"
"Census Tract 9303.02, Haywood County, Tennessee","350","294","332","83","1205","1059","146","358","701","1205","31781","47","075","47075","2020"
"Census Tract 9304, Haywood County, Tennessee","503","597","286","107","1763","1493","270","701","792","1763","34561","47","075","47075","2020"
"Census Tract 9305, Haywood County, Tennessee","513","607","214","42","1670","1376","294","1013","363","1670","39239","47","075","47075","2020"
"Census Tract 203.01, Shelby County, Tennessee","314","174","192","28","708","708","0","623","85","708","73673","47","157","47157","2020"
"Census Tract 203.02, Shelby County, Tennessee","470","378","208","106","1618","1162","456","505","657","1618","43725","47","157","47157","2020"
"Census Tract 204, Shelby County, Tennessee","21","160","139","0","404","320","84","16","304","404","76389","47","157","47157","2020"
"Census Tract 205.11, Shelby County, Tennessee","162","236","208","206","951","812","139","666","146","951","66875","47","157","47157","2020"
"Census Tract 205.21, Shelby County, Tennessee","655","462","139","47","1587","1303","284","461","842","1587","25784","47","157","47157","2020"
"Census Tract 205.23, Shelby County, Tennessee","371","477","159","100","1500","1107","393","254","853","1500","31768","47","157","47157","2020"
"Census Tract 205.24, Shelby County, Tennessee","319","673","470","165","1817","1627","190","928","699","1817","49216","47","157","47157","2020"
"Census Tract 205.31, Shelby County, Tennessee","253","777","471","156","1830","1657","173","678","979","1830","50938","47","157","47157","2020"
"Census Tract 205.32, Shelby County, Tennessee","381","1245","510","172","2435","2308","127","1068","1240","2435","42873","47","157","47157","2020"
"Census Tract 205.41, Shelby County, Tennessee","475","609","469","47","1947","1600","347","678","922","1947","51892","47","157","47157","2020"
"Census Tract 205.42, Shelby County, Tennessee","522","832","577","315","2642","2246","396","276","1970","2642","37500","47","157","47157","2020"
"Census Tract 205.43, Shelby County, Tennessee","640","466","327","55","1831","1488","343","339","1149","1831","20533","47","157","47157","2020"
"Census Tract 205.44, Shelby County, Tennessee","489","402","127","23","1500","1041","459","400","641","1500","28591","47","157","47157","2020"
"Census Tract 206.10, Shelby County, Tennessee","372","839","277","108","1763","1596","167","523","1073","1763","34342","47","157","47157","2020"
"Census Tract 206.21, Shelby County, Tennessee","466","1484","950","172","3158","3072","86","1235","1837","3158","41629","47","157","47157","2020"
"Census Tract 206.22, Shelby County, Tennessee","517","525","593","46","1879","1681","198","1177","504","1879","54078","47","157","47157","2020"
"Census Tract 206.32, Shelby County, Tennessee","397","627","631","183","1882","1838","44","1601","237","1882","80948","47","157","47157","2020"
"Census Tract 206.33, Shelby County, Tennessee","362","536","249","41","1298","1188","110","1010","178","1298","64922","47","157","47157","2020"
"Census Tract 206.34, Shelby County, Tennessee","285","329","383","98","1117","1095","22","998","97","1117","78622","47","157","47157","2020"
"Census Tract 206.35, Shelby County, Tennessee","274","342","308","64","1018","988","30","917","71","1018","55882","47","157","47157","2020"
"Census Tract 206.51, Shelby County, Tennessee","596","812","699","232","2499","2339","160","1521","818","2499","63211","47","157","47157","2020"
"Census Tract 206.52, Shelby County, Tennessee","491","639","492","159","1937","1781","156","1438","343","1937","68498","47","157","47157","2020"
"Census Tract 206.53, Shelby County, Tennessee","249","510","585","67","1411","1411","0","1398","13","1411","103267","47","157","47157","2020"
"Census Tract 206.54, Shelby County, Tennessee","672","675","542","224","2113","2113","0","1771","342","2113","78085","47","157","47157","2020"
"Census Tract 206.55, Shelby County, Tennessee","376","418","398","52","1267","1244","23","1163","81","1267","87153","47","157","47157","2020"
"Census Tract 206.56, Shelby County, Tennessee","210","753","596","177","1806","1736","70","1228","508","1806","90598","47","157","47157","2020"
"Census Tract 206.57, Shelby County, Tennessee","148","500","828","193","1789","1669","120","1231","438","1789","89673","47","157","47157","2020"
"Census Tract 206.58, Shelby County, Tennessee","533","415","670","234","1904","1852","52","1285","567","1904","61250","47","157","47157","2020"
"Census Tract 207, Shelby County, Tennessee","198","286","261","56","869","801","68","711","90","869","79213","47","157","47157","2020"
"Census Tract 208.33, Shelby County, Tennessee","515","431","678","142","1766","1766","0","1585","181","1766","99722","47","157","47157","2020"
"Census Tract 208.34, Shelby County, Tennessee","276","483","493","46","1298","1298","0","1039","259","1298","122500","47","157","47157","2020"
"Census Tract 208.35, Shelby County, Tennessee","222","306","205","92","882","825","57","781","44","882","81444","47","157","47157","2020"
"Census Tract 208.36, Shelby County, Tennessee","314","959","823","231","2366","2327","39","2185","142","2366","135250","47","157","47157","2020"
"Census Tract 208.37, Shelby County, Tennessee","539","1000","838","126","2557","2503","54","2028","475","2557","71729","47","157","47157","2020"
"Census Tract 209.01, Shelby County, Tennessee","242","329","623","213","1407","1407","0","1017","390","1407","94654","47","157","47157","2020"
"Census Tract 209.02, Shelby County, Tennessee","234","474","892","88","1731","1688","43","1580","108","1731","110056","47","157","47157","2020"
"Census Tract 210.20, Shelby County, Tennessee","308","775","648","130","1993","1861","132","1504","357","1993","92555","47","157","47157","2020"
"Census Tract 210.21, Shelby County, Tennessee","381","535","603","280","2022","1799","223","1141","658","2022","61657","47","157","47157","2020"
"Census Tract 210.22, Shelby County, Tennessee","378","1022","710","80","2390","2190","200","1071","1119","2390","60349","47","157","47157","2020"
"Census Tract 210.23, Shelby County, Tennessee","784","400","1214","143","2790","2541","249","2121","420","2790","102195","47","157","47157","2020"
"Census Tract 211.11, Shelby County, Tennessee","260","842","528","52","1745","1682","63","542","1140","1745","35773","47","157","47157","2020"
"Census Tract 211.12, Shelby County, Tennessee","187","1584","462","99","2460","2332","128","1388","944","2460","44704","47","157","47157","2020"
"Census Tract 211.13, Shelby County, Tennessee","339","649","473","122","1656","1583","73","921","662","1656","64186","47","157","47157","2020"
"Census Tract 211.21, Shelby County, Tennessee","920","1406","420","69","2963","2815","148","699","2116","2963","38523","47","157","47157","2020"
"Census Tract 211.22, Shelby County, Tennessee","295","995","586","233","2324","2109","215","881","1228","2324","51398","47","157","47157","2020"
"Census Tract 9750, Henderson County, Tennessee","317","544","348","89","1453","1298","155","944","354","1453","70050","47","077","47077","2020"
"Census Tract 9751, Henderson County, Tennessee","676","531","294","38","1807","1539","268","1308","231","1807","44199","47","077","47077","2020"
"Census Tract 9752, Henderson County, Tennessee","704","495","575","89","2344","1863","481","1644","219","2344","41929","47","077","47077","2020"
"Census Tract 9753.01, Henderson County, Tennessee","332","358","447","43","1392","1180","212","905","275","1392","51094","47","077","47077","2020"
"Census Tract 9753.02, Henderson County, Tennessee","593","387","370","232","1848","1582","266","1022","560","1848","45763","47","077","47077","2020"
"Census Tract 9754, Henderson County, Tennessee","841","689","458","0","2373","1988","385","1166","822","2373","32700","47","077","47077","2020"
"Census Tract 9755, Henderson County, Tennessee","592","452","410","10","1820","1464","356","1066","398","1820","37285","47","077","47077","2020"
"Census Tract 9690.01, Henry County, Tennessee","479","274","164","0","2075","917","1158","818","99","2075","46281","47","079","47079","2020"
"Census Tract 9690.02, Henry County, Tennessee","414","332","88","0","1010","834","176","754","80","1010","47000","47","079","47079","2020"
"Census Tract 9691, Henry County, Tennessee","394","383","291","68","1397","1136","261","934","202","1397","44079","47","079","47079","2020"
"Census Tract 9692, Henry County, Tennessee","247","197","206","33","810","683","127","525","158","810","44948","47","079","47079","2020"
"Census Tract 9693, Henry County, Tennessee","568","610","246","27","1803","1451","352","654","797","1803","33668","47","079","47079","2020"
"Census Tract 9694, Henry County, Tennessee","261","291","170","25","1033","747","286","382","365","1033","30387","47","079","47079","2020"
"Census Tract 9695.01, Henry County, Tennessee","429","131","161","25","778","746","32","531","215","778","32092","47","079","47079","2020"
"Census Tract 9695.02, Henry County, Tennessee","560","465","391","15","1737","1431","306","890","541","1737","33961","47","079","47079","2020"
"Census Tract 9696.01, Henry County, Tennessee","499","341","333","78","1459","1251","208","948","303","1459","39976","47","079","47079","2020"
"Census Tract 9696.02, Henry County, Tennessee","616","681","527","102","2102","1926","176","1714","212","2102","53065","47","079","47079","2020"
"Census Tract 9697, Henry County, Tennessee","667","283","157","9","1895","1116","779","966","150","1895","43176","47","079","47079","2020"
"Census Tract 9698, Henry County, Tennessee","389","314","201","48","1171","952","219","797","155","1171","42783","47","079","47079","2020"
"Census Tract 9501, Hickman County, Tennessee","430","765","680","119","2297","1994","303","1714","280","2297","49568","47","081","47081","2020"
"Census Tract 9502.01, Hickman County, Tennessee","407","461","518","48","1636","1434","202","1245","189","1636","46790","47","081","47081","2020"
"Census Tract 9502.02, Hickman County, Tennessee","288","424","290","172","1425","1174","251","1004","170","1425","53256","47","081","47081","2020"
"Census Tract 9503.01, Hickman County, Tennessee","432","375","274","36","1302","1117","185","800","317","1302","41156","47","081","47081","2020"
"Census Tract 9503.02, Hickman County, Tennessee","543","756","395","47","2181","1741","440","1270","471","2181","43750","47","081","47081","2020"
"Census Tract 9504, Hickman County, Tennessee","338","225","161","32","1047","756","291","697","59","1047","50000","47","081","47081","2020"
"Census Tract 9505, Hickman County, Tennessee","106","223","92","38","653","459","194","394","65","653","50331","47","081","47081","2020"
"Census Tract 1201, Houston County, Tennessee","337","441","132","75","1412","985","427","812","173","1412","44801","47","083","47083","2020"
"Census Tract 1202, Houston County, Tennessee","393","278","119","36","1035","826","209","638","188","1035","47734","47","083","47083","2020"
"Census Tract 1203, Houston County, Tennessee","599","289","168","52","1791","1108","683","872","236","1791","38071","47","083","47083","2020"
"Census Tract 1301, Humphreys County, Tennessee","800","576","507","131","2254","2014","240","1659","355","2254","52368","47","085","47085","2020"
"Census Tract 1302, Humphreys County, Tennessee","255","251","103","14","1172","623","549","504","119","1172","44007","47","085","47085","2020"
"Census Tract 1303, Humphreys County, Tennessee","849","1083","405","25","2861","2362","499","1703","659","2861","40500","47","085","47085","2020"
"Census Tract 1304, Humphreys County, Tennessee","281","259","288","11","1313","839","474","729","110","1313","54353","47","085","47085","2020"
"Census Tract 1305, Humphreys County, Tennessee","266","471","276","18","1383","1031","352","794","237","1383","61875","47","085","47085","2020"
"Census Tract 9601, Jackson County, Tennessee","343","254","109","1","1071","707","364","578","129","1071","42933","47","087","47087","2020"
"Census Tract 9602, Jackson County, Tennessee","312","424","170","48","1334","954","380","819","135","1334","34240","47","087","47087","2020"
"Census Tract 9603, Jackson County, Tennessee","739","669","500","114","2484","2022","462","1559","463","2484","43580","47","087","47087","2020"
"Census Tract 9604, Jackson County, Tennessee","439","272","99","32","1030","842","188","685","157","1030","22721","47","087","47087","2020"
"Census Tract 701.01, Jefferson County, Tennessee","296","259","266","52","1032","873","159","681","192","1032","57009","47","089","47089","2020"
"Census Tract 701.02, Jefferson County, Tennessee","792","844","390","109","2361","2135","226","1782","353","2361","56767","47","089","47089","2020"
"Census Tract 702, Jefferson County, Tennessee","501","746","569","73","2188","1889","299","1562","327","2188","61563","47","089","47089","2020"
"Census Tract 703, Jefferson County, Tennessee","826","950","406","168","2873","2350","523","1227","1123","2873","43383","47","089","47089","2020"
"Census Tract 704, Jefferson County, Tennessee","454","362","504","161","1722","1481","241","1225","256","1722","55677","47","089","47089","2020"
"Census Tract 705, Jefferson County, Tennessee","706","629","375","135","2152","1845","307","1473","372","2152","46356","47","089","47089","2020"
"Census Tract 706, Jefferson County, Tennessee","586","574","430","242","2065","1832","233","1153","679","2065","50631","47","089","47089","2020"
"Census Tract 211.24, Shelby County, Tennessee","449","1122","718","428","2966","2717","249","1472","1245","2966","63269","47","157","47157","2020"
"Census Tract 211.25, Shelby County, Tennessee","332","910","571","68","1918","1881","37","936","945","1918","66820","47","157","47157","2020"
"Census Tract 211.26, Shelby County, Tennessee","518","772","633","114","2123","2037","86","737","1300","2123","53704","47","157","47157","2020"
"Census Tract 211.35, Shelby County, Tennessee","420","1119","879","67","2788","2485","303","1102","1383","2788","57482","47","157","47157","2020"
"Census Tract 211.36, Shelby County, Tennessee","457","680","627","222","2045","1986","59","1498","488","2045","104295","47","157","47157","2020"
"Census Tract 211.38, Shelby County, Tennessee","258","467","572","80","1429","1377","52","863","514","1429","89869","47","157","47157","2020"
"Census Tract 211.39, Shelby County, Tennessee","213","567","669","73","1576","1522","54","1368","154","1576","130234","47","157","47157","2020"
"Census Tract 211.40, Shelby County, Tennessee","487","781","888","137","2463","2293","170","1317","976","2463","69245","47","157","47157","2020"
"Census Tract 211.41, Shelby County, Tennessee","490","1205","913","274","3067","2882","185","1932","950","3067","74133","47","157","47157","2020"
"Census Tract 211.42, Shelby County, Tennessee","244","834","394","106","1655","1578","77","907","671","1655","73750","47","157","47157","2020"
"Census Tract 211.43, Shelby County, Tennessee","293","851","731","125","2000","2000","0","1405","595","2000","74906","47","157","47157","2020"
"Census Tract 211.44, Shelby County, Tennessee","418","619","474","52","1604","1563","41","646","917","1604","51036","47","157","47157","2020"
"Census Tract 212, Shelby County, Tennessee","0","0","0","0","0","0","0","0","0","0","-666666666","47","157","47157","2020"
"Census Tract 213.11, Shelby County, Tennessee","557","829","511","219","2305","2116","189","1739","377","2305","174057","47","157","47157","2020"
"Census Tract 213.12, Shelby County, Tennessee","238","514","335","0","1168","1087","81","391","696","1168","55801","47","157","47157","2020"
"Census Tract 213.20, Shelby County, Tennessee","397","1011","683","59","2343","2150","193","1251","899","2343","78359","47","157","47157","2020"
"Census Tract 213.31, Shelby County, Tennessee","359","408","483","124","1394","1374","20","1172","202","1394","86935","47","157","47157","2020"
"Census Tract 213.33, Shelby County, Tennessee","133","635","686","124","1700","1578","122","1047","531","1700","84625","47","157","47157","2020"
"Census Tract 213.34, Shelby County, Tennessee","226","1028","704","115","2168","2073","95","888","1185","2168","65760","47","157","47157","2020"
"Census Tract 213.41, Shelby County, Tennessee","775","585","630","124","2214","2114","100","1433","681","2214","110321","47","157","47157","2020"
"Census Tract 213.51, Shelby County, Tennessee","492","571","623","71","1946","1757","189","1319","438","1946","103536","47","157","47157","2020"
"Census Tract 213.52, Shelby County, Tennessee","807","595","939","148","2575","2489","86","2302","187","2575","120858","47","157","47157","2020"
"Census Tract 213.54, Shelby County, Tennessee","281","1949","448","123","2993","2801","192","503","2298","2993","63504","47","157","47157","2020"
"Census Tract 213.55, Shelby County, Tennessee","323","731","819","146","2168","2019","149","1362","657","2168","123315","47","157","47157","2020"
"Census Tract 213.56, Shelby County, Tennessee","181","711","224","66","1182","1182","0","1148","34","1182","175200","47","157","47157","2020"
"Census Tract 213.57, Shelby County, Tennessee","343","882","738","54","2030","2017","13","1985","32","2030","190938","47","157","47157","2020"
"Census Tract 214.10, Shelby County, Tennessee","305","542","407","18","1300","1272","28","1154","118","1300","103929","47","157","47157","2020"
"Census Tract 214.20, Shelby County, Tennessee","303","462","471","11","1273","1247","26","1078","169","1273","101114","47","157","47157","2020"
"Census Tract 214.30, Shelby County, Tennessee","370","733","508","54","1800","1665","135","1411","254","1800","110104","47","157","47157","2020"
"Census Tract 215.30, Shelby County, Tennessee","308","737","651","170","1909","1866","43","1665","201","1909","131600","47","157","47157","2020"
"Census Tract 215.41, Shelby County, Tennessee","254","931","1067","157","2480","2409","71","2184","225","2480","154120","47","157","47157","2020"
"Census Tract 215.42, Shelby County, Tennessee","374","571","706","251","1933","1902","31","1599","303","1933","166064","47","157","47157","2020"
"Census Tract 215.43, Shelby County, Tennessee","108","470","391","121","1090","1090","0","1058","32","1090","122222","47","157","47157","2020"
"Census Tract 215.44, Shelby County, Tennessee","138","725","424","27","1704","1314","390","419","895","1704","101289","47","157","47157","2020"
"Census Tract 215.45, Shelby County, Tennessee","447","566","222","63","1298","1298","0","859","439","1298","108670","47","157","47157","2020"
"Census Tract 215.46, Shelby County, Tennessee","168","1164","319","45","1818","1696","122","369","1327","1818","115431","47","157","47157","2020"
"Census Tract 215.47, Shelby County, Tennessee","196","1239","634","103","2328","2172","156","1152","1020","2328","65978","47","157","47157","2020"
"Census Tract 215.48, Shelby County, Tennessee","106","812","242","76","1380","1236","144","434","802","1380","80652","47","157","47157","2020"
"Census Tract 216.11, Shelby County, Tennessee","276","741","851","137","2046","2005","41","1758","247","2046","108693","47","157","47157","2020"
"Census Tract 216.12, Shelby County, Tennessee","247","639","656","147","1727","1689","38","1557","132","1727","106156","47","157","47157","2020"
"Census Tract 216.13, Shelby County, Tennessee","278","553","538","230","1619","1599","20","1528","71","1619","104517","47","157","47157","2020"
"Census Tract 216.20, Shelby County, Tennessee","356","455","203","134","1200","1148","52","508","640","1200","60372","47","157","47157","2020"
"Census Tract 217.10, Shelby County, Tennessee","374","757","112","23","1390","1266","124","282","984","1390","23476","47","157","47157","2020"
"Census Tract 217.21, Shelby County, Tennessee","285","1153","345","91","2278","1874","404","215","1659","2278","32328","47","157","47157","2020"
"Census Tract 217.24, Shelby County, Tennessee","118","504","307","31","1055","960","95","301","659","1055","46173","47","157","47157","2020"
"Census Tract 707.01, Jefferson County, Tennessee","426","322","443","281","1632","1472","160","1146","326","1632","68654","47","089","47089","2020"
"Census Tract 707.02, Jefferson County, Tennessee","668","366","406","110","2084","1550","534","1394","156","2084","61346","47","089","47089","2020"
"Census Tract 708.01, Jefferson County, Tennessee","305","680","408","126","1601","1519","82","1252","267","1601","51150","47","089","47089","2020"
"Census Tract 708.02, Jefferson County, Tennessee","599","524","230","157","1818","1510","308","998","512","1818","50893","47","089","47089","2020"
"Census Tract 709, Jefferson County, Tennessee","649","458","372","103","2825","1582","1243","1281","301","2825","42857","47","089","47089","2020"
"Census Tract 9560, Johnson County, Tennessee","270","145","97","13","637","525","112","459","66","637","35529","47","091","47091","2020"
"Census Tract 9561, Johnson County, Tennessee","365","408","297","16","1396","1086","310","797","289","1396","45357","47","091","47091","2020"
"Census Tract 9562, Johnson County, Tennessee","315","515","186","26","1409","1042","367","875","167","1409","42643","47","091","47091","2020"
"Census Tract 9563, Johnson County, Tennessee","1204","612","451","50","3034","2317","717","1468","849","3034","32488","47","091","47091","2020"
"Census Tract 9564, Johnson County, Tennessee","969","524","383","133","2521","2009","512","1673","336","2521","38718","47","091","47091","2020"
"Census Tract 1, Knox County, Tennessee","506","712","422","0","1903","1640","263","359","1281","1903","48712","47","093","47093","2020"
"Census Tract 8, Knox County, Tennessee","393","767","282","198","1877","1640","237","266","1374","1877","27110","47","093","47093","2020"
"Census Tract 9.01, Knox County, Tennessee","0","0","4","0","4","4","0","0","4","4","-666666666","47","093","47093","2020"
"Census Tract 9.02, Knox County, Tennessee","51","0","0","15","115","66","49","0","66","115","2499","47","093","47093","2020"
"Census Tract 14, Knox County, Tennessee","356","214","209","13","1112","792","320","234","558","1112","23519","47","093","47093","2020"
"Census Tract 15, Knox County, Tennessee","270","831","397","102","1781","1600","181","732","868","1781","49944","47","093","47093","2020"
"Census Tract 16, Knox County, Tennessee","787","555","275","97","1912","1714","198","1030","684","1912","41250","47","093","47093","2020"
"Census Tract 17, Knox County, Tennessee","315","388","359","16","1300","1078","222","477","601","1300","37583","47","093","47093","2020"
"Census Tract 18, Knox County, Tennessee","332","477","304","21","1160","1134","26","867","267","1160","43929","47","093","47093","2020"
"Census Tract 19, Knox County, Tennessee","164","317","157","4","814","642","172","259","383","814","30083","47","093","47093","2020"
"Census Tract 20, Knox County, Tennessee","507","633","181","37","1625","1358","267","573","785","1625","25526","47","093","47093","2020"
"Census Tract 21, Knox County, Tennessee","376","530","280","85","1410","1271","139","668","603","1410","36295","47","093","47093","2020"
"Census Tract 22, Knox County, Tennessee","445","578","507","54","1767","1584","183","924","660","1767","47868","47","093","47093","2020"
"Census Tract 23, Knox County, Tennessee","301","831","407","35","1753","1574","179","623","951","1753","35203","47","093","47093","2020"
"Census Tract 24, Knox County, Tennessee","618","643","447","70","2016","1778","238","756","1022","2016","35625","47","093","47093","2020"
"Census Tract 26, Knox County, Tennessee","289","464","266","63","1192","1082","110","180","902","1192","27989","47","093","47093","2020"
"Census Tract 27, Knox County, Tennessee","355","363","291","47","1227","1056","171","529","527","1227","33043","47","093","47093","2020"
"Census Tract 28, Knox County, Tennessee","497","913","461","2","2254","1873","381","487","1386","2254","31199","47","093","47093","2020"
"Census Tract 29, Knox County, Tennessee","554","804","139","34","1783","1531","252","486","1045","1783","25761","47","093","47093","2020"
"Census Tract 30, Knox County, Tennessee","581","1051","614","47","2532","2293","239","1238","1055","2532","42473","47","093","47093","2020"
"Census Tract 31, Knox County, Tennessee","495","412","332","17","1380","1256","124","999","257","1380","40284","47","093","47093","2020"
"Census Tract 32, Knox County, Tennessee","541","728","117","62","1693","1448","245","697","751","1693","33190","47","093","47093","2020"
"Census Tract 33, Knox County, Tennessee","301","384","251","23","1011","959","52","872","87","1011","71250","47","093","47093","2020"
"Census Tract 34, Knox County, Tennessee","522","541","722","73","2049","1858","191","1304","554","2049","58500","47","093","47093","2020"
"Census Tract 35.01, Knox County, Tennessee","421","475","414","57","1528","1367","161","859","508","1528","64583","47","093","47093","2020"
"Census Tract 35.02, Knox County, Tennessee","323","234","221","109","1134","887","247","285","602","1134","26779","47","093","47093","2020"
"Census Tract 37, Knox County, Tennessee","550","706","303","7","1718","1566","152","709","857","1718","40074","47","093","47093","2020"
"Census Tract 38.01, Knox County, Tennessee","463","899","794","68","2338","2224","114","622","1602","2338","40721","47","093","47093","2020"
"Census Tract 38.02, Knox County, Tennessee","201","672","437","75","1456","1385","71","780","605","1456","51220","47","093","47093","2020"
"Census Tract 39.01, Knox County, Tennessee","546","724","478","146","2001","1894","107","1403","491","2001","40000","47","093","47093","2020"
"Census Tract 39.02, Knox County, Tennessee","366","610","347","71","1507","1394","113","914","480","1507","38456","47","093","47093","2020"
"Census Tract 40, Knox County, Tennessee","941","1000","584","80","2859","2605","254","1020","1585","2859","33270","47","093","47093","2020"
"Census Tract 41, Knox County, Tennessee","442","971","522","166","2237","2101","136","1235","866","2237","50655","47","093","47093","2020"
"Census Tract 42, Knox County, Tennessee","376","449","492","110","1579","1427","152","826","601","1579","52702","47","093","47093","2020"
"Census Tract 43, Knox County, Tennessee","409","589","300","93","1579","1391","188","686","705","1579","43606","47","093","47093","2020"
"Census Tract 44.01, Knox County, Tennessee","679","679","639","132","2405","2129","276","1865","264","2405","85766","47","093","47093","2020"
"Census Tract 217.25, Shelby County, Tennessee","287","1398","500","60","2710","2245","465","34","2211","2710","34616","47","157","47157","2020"
"Census Tract 217.31, Shelby County, Tennessee","218","334","286","73","1011","911","100","306","605","1011","41474","47","157","47157","2020"
"Census Tract 217.44, Shelby County, Tennessee","417","859","621","276","2246","2173","73","1611","562","2246","63758","47","157","47157","2020"
"Census Tract 217.45, Shelby County, Tennessee","286","876","1229","339","2861","2730","131","2283","447","2861","82813","47","157","47157","2020"
"Census Tract 217.46, Shelby County, Tennessee","264","829","601","43","1923","1737","186","714","1023","1923","50008","47","157","47157","2020"
"Census Tract 217.47, Shelby County, Tennessee","193","632","430","36","1361","1291","70","944","347","1361","48495","47","157","47157","2020"
"Census Tract 217.51, Shelby County, Tennessee","235","818","704","271","2172","2028","144","1590","438","2172","76786","47","157","47157","2020"
"Census Tract 217.52, Shelby County, Tennessee","440","814","449","220","1948","1923","25","991","932","1948","52517","47","157","47157","2020"
"Census Tract 217.53, Shelby County, Tennessee","102","503","385","55","1073","1045","28","950","95","1073","64107","47","157","47157","2020"
"Census Tract 217.54, Shelby County, Tennessee","393","832","306","124","1743","1655","88","989","666","1743","47321","47","157","47157","2020"
"Census Tract 217.55, Shelby County, Tennessee","159","610","125","14","1149","908","241","0","908","1149","29302","47","157","47157","2020"
"Census Tract 217.56, Shelby County, Tennessee","532","295","208","18","1552","1053","499","293","760","1552","35272","47","157","47157","2020"
"Census Tract 217.57, Shelby County, Tennessee","334","834","217","38","1769","1423","346","221","1202","1769","32839","47","157","47157","2020"
"Census Tract 217.58, Shelby County, Tennessee","382","662","426","0","1490","1470","20","439","1031","1490","30929","47","157","47157","2020"
"Census Tract 217.59, Shelby County, Tennessee","268","563","504","56","1533","1391","142","627","764","1533","50655","47","157","47157","2020"
"Census Tract 217.60, Shelby County, Tennessee","188","822","376","44","1464","1430","34","891","539","1464","42246","47","157","47157","2020"
"Census Tract 219, Shelby County, Tennessee","446","1043","390","16","2088","1895","193","935","960","2088","50594","47","157","47157","2020"
"Census Tract 220.23, Shelby County, Tennessee","221","209","130","21","1598","581","1017","272","309","1598","46458","47","157","47157","2020"
"Census Tract 220.24, Shelby County, Tennessee","358","566","216","31","1203","1171","32","758","413","1203","38625","47","157","47157","2020"
"Census Tract 220.25, Shelby County, Tennessee","503","508","180","0","1773","1191","582","112","1079","1773","28480","47","157","47157","2020"
"Census Tract 220.26, Shelby County, Tennessee","108","322","145","34","872","609","263","138","471","872","30625","47","157","47157","2020"
"Census Tract 221.11, Shelby County, Tennessee","706","1239","427","44","2665","2416","249","846","1570","2665","31156","47","157","47157","2020"
"Census Tract 221.21, Shelby County, Tennessee","545","549","480","66","1789","1640","149","1224","416","1789","53981","47","157","47157","2020"
"Census Tract 221.22, Shelby County, Tennessee","403","704","460","73","2012","1640","372","799","841","2012","44338","47","157","47157","2020"
"Census Tract 221.30, Shelby County, Tennessee","581","1028","358","73","2315","2040","275","1419","621","2315","47306","47","157","47157","2020"
"Census Tract 221.31, Shelby County, Tennessee","314","669","207","0","1330","1190","140","254","936","1330","35726","47","157","47157","2020"
"Census Tract 221.32, Shelby County, Tennessee","502","550","123","141","1472","1316","156","450","866","1472","34167","47","157","47157","2020"
"Census Tract 222.10, Shelby County, Tennessee","691","700","164","51","1869","1606","263","1200","406","1869","38333","47","157","47157","2020"
"Census Tract 222.20, Shelby County, Tennessee","634","511","253","96","1982","1494","488","761","733","1982","27864","47","157","47157","2020"
"Census Tract 223.10, Shelby County, Tennessee","1071","713","115","10","2125","1909","216","829","1080","2125","24130","47","157","47157","2020"
"Census Tract 223.21, Shelby County, Tennessee","624","449","222","38","1510","1333","177","847","486","1510","32724","47","157","47157","2020"
"Census Tract 223.22, Shelby County, Tennessee","592","517","253","83","1619","1445","174","948","497","1619","45657","47","157","47157","2020"
"Census Tract 223.30, Shelby County, Tennessee","443","863","362","51","1851","1719","132","1041","678","1851","37270","47","157","47157","2020"
"Census Tract 224.10, Shelby County, Tennessee","799","906","486","45","2501","2236","265","1808","428","2501","46653","47","157","47157","2020"
"Census Tract 225, Shelby County, Tennessee","673","690","270","77","2018","1710","308","1118","592","2018","41124","47","157","47157","2020"
"Census Tract 226, Shelby County, Tennessee","279","659","331","43","1677","1312","365","550","762","1677","37760","47","157","47157","2020"
"Census Tract 227, Shelby County, Tennessee","948","1451","406","70","3102","2875","227","1404","1471","3102","28962","47","157","47157","2020"
"Census Tract 9801, Shelby County, Tennessee","0","0","0","0","0","0","0","0","0","0","-666666666","47","157","47157","2020"
"Census Tract 9802, Shelby County, Tennessee","0","0","0","0","0","0","0","0","0","0","-666666666","47","157","47157","2020"
"Census Tract 9803, Shelby County, Tennessee","0","0","0","0","0","0","0","0","0","0","-666666666","47","157","47157","2020"
"Census Tract 9804.01, Shelby County, Tennessee","0","0","0","0","0","0","0","0","0","0","-666666666","47","157","47157","2020"
"Census Tract 9804.02, Shelby County, Tennessee","0","0","0","0","0","0","0","0","0","0","-666666666","47","157","47157","2020"
"Census Tract 9750, Smith County, Tennessee","509","558","441","119","2021","1627","394","1376","251","2021","50369","47","159","47159","2020"
"Census Tract 9751, Smith County, Tennessee","402","540","310","38","1360","1290","70","812","478","1360","44123","47","159","47159","2020"
"Census Tract 9752, Smith County, Tennessee","767","705","705","66","2421","2243","178","1677","566","2421","46733","47","159","47159","2020"
"Census Tract 201, Anderson County, Tennessee","437","695","317","58","1791","1507","284","361","1146","1791","36130","47","001","47001","2020"
"Census Tract 202.01, Anderson County, Tennessee","452","706","553","86","1940","1797","143","1088","709","1940","91078","47","001","47001","2020"
"Census Tract 202.02, Anderson County, Tennessee","678","647","369","32","2220","1726","494","1141","585","2220","46944","47","001","47001","2020"
"Census Tract 203, Anderson County, Tennessee","353","523","534","35","1705","1445","260","984","461","1705","55290","47","001","47001","2020"
"Census Tract 204, Anderson County, Tennessee","632","867","302","54","2151","1855","296","1098","757","2151","49025","47","001","47001","2020"
"Census Tract 205, Anderson County, Tennessee","394","669","407","24","1810","1494","316","793","701","1810","42813","47","001","47001","2020"
"Census Tract 206, Anderson County, Tennessee","307","260","256","45","959","868","91","733","135","959","71154","47","001","47001","2020"
"Census Tract 207, Anderson County, Tennessee","209","227","131","35","743","602","141","559","43","743","39865","47","001","47001","2020"
"Census Tract 208, Anderson County, Tennessee","663","698","503","100","2154","1964","190","1297","667","2154","40482","47","001","47001","2020"
"Census Tract 209.01, Anderson County, Tennessee","730","787","635","114","2853","2266","587","1793","473","2853","52344","47","001","47001","2020"
"Census Tract 209.02, Anderson County, Tennessee","670","1053","588","165","2624","2476","148","1951","525","2624","53316","47","001","47001","2020"
"Census Tract 210.01, Anderson County, Tennessee","395","398","236","0","1196","1029","167","715","314","1196","42708","47","001","47001","2020"
"Census Tract 210.02, Anderson County, Tennessee","677","378","269","70","1418","1394","24","1149","245","1418","50709","47","001","47001","2020"
"Census Tract 211, Anderson County, Tennessee","560","692","435","16","1858","1703","155","1408","295","1858","85456","47","001","47001","2020"
"Census Tract 212.01, Anderson County, Tennessee","605","616","585","80","2049","1886","163","1373","513","2049","51908","47","001","47001","2020"
"Census Tract 212.02, Anderson County, Tennessee","1261","768","523","45","2916","2597","319","1050","1547","2916","36930","47","001","47001","2020"
"Census Tract 213.01, Anderson County, Tennessee","329","451","504","69","1587","1353","234","1157","196","1587","61763","47","001","47001","2020"
"Census Tract 213.03, Anderson County, Tennessee","635","618","221","73","1612","1547","65","1378","169","1612","76284","47","001","47001","2020"
"Census Tract 213.04, Anderson County, Tennessee","331","711","285","50","1471","1377","94","858","519","1471","40375","47","001","47001","2020"
"Census Tract 9801, Anderson County, Tennessee","0","0","0","0","0","0","0","0","0","0","-666666666","47","001","47001","2020"
"Census Tract 9501, Bedford County, Tennessee","404","566","576","158","1825","1704","121","1597","107","1825","64250","47","003","47003","2020"
"Census Tract 9502.01, Bedford County, Tennessee","347","517","238","143","1391","1245","146","1127","118","1391","73304","47","003","47003","2020"
"Census Tract 9502.02, Bedford County, Tennessee","229","636","562","16","1559","1443","116","1057","386","1559","54229","47","003","47003","2020"
"Census Tract 9503, Bedford County, Tennessee","345","377","418","80","1438","1220","218","1047","173","1438","55950","47","003","47003","2020"
"Census Tract 9504.01, Bedford County, Tennessee","464","564","715","230","2125","1973","152","1537","436","2125","65860","47","003","47003","2020"
"Census Tract 9504.02, Bedford County, Tennessee","883","1006","569","143","2763","2601","162","1417","1184","2763","39386","47","003","47003","2020"
"Census Tract 9505, Bedford County, Tennessee","417","1212","384","347","2644","2360","284","1255","1105","2644","42222","47","003","47003","2020"
"Census Tract 9506, Bedford County, Tennessee","559","914","744","224","2814","2441","373","1146","1295","2814","48727","47","003","47003","2020"
"Census Tract 9507, Bedford County, Tennessee","355","487","396","41","1445","1279","166","1076","203","1445","51543","47","003","47003","2020"
"Census Tract 9508, Bedford County, Tennessee","332","345","449","98","1341","1224","117","1167","57","1341","71306","47","003","47003","2020"
"Census Tract 9630, Benton County, Tennessee","720","438","288","5","2212","1451","761","1134","317","2212","43114","47","005","47005","2020"
"Census Tract 9631, Benton County, Tennessee","666","331","217","61","1812","1275","537","1024","251","1812","43925","47","005","47005","2020"
"Census Tract 9632, Benton County, Tennessee","538","348","74","44","1446","1004","442","828","176","1446","37500","47","005","47005","2020"
"Census Tract 9633, Benton County, Tennessee","633","479","279","69","1739","1460","279","894","566","1739","38086","47","005","47005","2020"
"Census Tract 9634, Benton County, Tennessee","701","557","225","97","1949","1580","369","1250","330","1949","34858","47","005","47005","2020"
"Census Tract 9530, Bledsoe County, Tennessee","738","327","279","45","1716","1389","327","1166","223","1716","37530","47","007","47007","2020"
"Census Tract 9531.01, Bledsoe County, Tennessee","280","55","249","87","713","671","42","603","68","713","90301","47","007","47007","2020"
"Census Tract 9531.02, Bledsoe County, Tennessee","476","381","459","47","1622","1363","259","743","620","1622","47847","47","007","47007","2020"
"Census Tract 9532, Bledsoe County, Tennessee","474","522","372","31","1720","1399","321","1184","215","1720","50547","47","007","47007","2020"
"Census Tract 101, Blount County, Tennessee","314","527","246","17","1298","1104","194","563","541","1298","38710","47","009","47009","2020"
"Census Tract 102, Blount County, Tennessee","874","911","778","89","2816","2652","164","2041","611","2816","51627","47","009","47009","2020"
"Census Tract 103.01, Blount County, Tennessee","317","1329","732","94","2937","2472","465","1026","1446","2937","52910","47","009","47009","2020"
"Census Tract 103.02, Blount County, Tennessee","249","592","427","131","1551","1399","152","1054","345","1551","69125","47","009","47009","2020"
"Census Tract 104, Blount County, Tennessee","325","415","304","158","1427","1202","225","985","217","1427","58750","47","009","47009","2020"
"Census Tract 44.03, Knox County, Tennessee","749","898","819","70","2814","2536","278","1144","1392","2814","46458","47","093","47093","2020"
"Census Tract 44.04, Knox County, Tennessee","379","765","586","88","2033","1818","215","705","1113","2033","59766","47","093","47093","2020"
"Census Tract 45.01, Knox County, Tennessee","327","697","480","38","1570","1542","28","444","1098","1570","44972","47","093","47093","2020"
"Census Tract 45.02, Knox County, Tennessee","489","594","601","38","1895","1722","173","788","934","1895","66176","47","093","47093","2020"
"Census Tract 46.06, Knox County, Tennessee","616","663","1345","172","2906","2796","110","2359","437","2906","97524","47","093","47093","2020"
"Census Tract 46.07, Knox County, Tennessee","375","794","788","221","2320","2178","142","1847","331","2320","84207","47","093","47093","2020"
"Census Tract 46.08, Knox County, Tennessee","177","435","361","40","1097","1013","84","890","123","1097","58580","47","093","47093","2020"
"Census Tract 46.09, Knox County, Tennessee","447","829","604","144","2321","2024","297","1181","843","2321","66007","47","093","47093","2020"
"Census Tract 46.10, Knox County, Tennessee","433","1029","500","155","2620","2117","503","287","1830","2620","47033","47","093","47093","2020"
"Census Tract 46.11, Knox County, Tennessee","398","422","581","241","1651","1642","9","1408","234","1651","86500","47","093","47093","2020"
"Census Tract 46.12, Knox County, Tennessee","111","680","303","66","1219","1160","59","758","402","1219","90891","47","093","47093","2020"
"Census Tract 46.13, Knox County, Tennessee","379","797","850","119","2353","2145","208","1424","721","2353","86825","47","093","47093","2020"
"Census Tract 46.14, Knox County, Tennessee","520","726","445","63","1789","1754","35","1157","597","1789","55192","47","093","47093","2020"
"Census Tract 46.15, Knox County, Tennessee","460","888","542","51","1965","1941","24","1023","918","1965","49279","47","093","47093","2020"
"Census Tract 47, Knox County, Tennessee","353","774","569","74","1911","1770","141","1160","610","1911","56689","47","093","47093","2020"
"Census Tract 48, Knox County, Tennessee","565","858","395","170","2167","1988","179","1485","503","2167","45411","47","093","47093","2020"
"Census Tract 49, Knox County, Tennessee","576","863","676","71","2503","2186","317","1317","869","2503","54798","47","093","47093","2020"
"Census Tract 50, Knox County, Tennessee","612","652","515","84","2151","1863","288","965","898","2151","50625","47","093","47093","2020"
"Census Tract 51, Knox County, Tennessee","528","884","958","347","2999","2717","282","2169","548","2999","92423","47","093","47093","2020"
"Census Tract 52.02, Knox County, Tennessee","564","399","412","75","1595","1450","145","1168","282","1595","43415","47","093","47093","2020"
"Census Tract 52.03, Knox County, Tennessee","285","359","568","155","1499","1367","132","1127","240","1499","66861","47","093","47093","2020"
"Census Tract 52.04, Knox County, Tennessee","123","312","237","10","682","682","0","520","162","682","58162","47","093","47093","2020"
"Census Tract 53.01, Knox County, Tennessee","522","585","716","91","2040","1914","126","1490","424","2040","70487","47","093","47093","2020"
"Census Tract 53.02, Knox County, Tennessee","317","453","619","73","1557","1462","95","1032","430","1557","54028","47","093","47093","2020"
"Census Tract 54.01, Knox County, Tennessee","541","507","295","126","1687","1469","218","1311","158","1687","55417","47","093","47093","2020"
"Census Tract 54.02, Knox County, Tennessee","408","409","211","174","1378","1202","176","988","214","1378","49900","47","093","47093","2020"
"Census Tract 55.01, Knox County, Tennessee","353","423","280","44","1168","1100","68","875","225","1168","53933","47","093","47093","2020"
"Census Tract 55.02, Knox County, Tennessee","297","433","365","27","1263","1122","141","869","253","1263","39643","47","093","47093","2020"
"Census Tract 56.02, Knox County, Tennessee","401","563","499","73","1730","1536","194","1341","195","1730","73125","47","093","47093","2020"
"Census Tract 56.03, Knox County, Tennessee","465","425","536","104","1732","1530","202","1352","178","1732","63929","47","093","47093","2020"
"Census Tract 56.04, Knox County, Tennessee","428","248","402","70","1292","1148","144","796","352","1292","65125","47","093","47093","2020"
"Census Tract 57.01, Knox County, Tennessee","392","837","694","31","2047","1954","93","1629","325","2047","124259","47","093","47093","2020"
"Census Tract 57.04, Knox County, Tennessee","470","1018","994","143","2795","2625","170","1568","1057","2795","68560","47","093","47093","2020"
"Census Tract 57.06, Knox County, Tennessee","625","617","509","82","2006","1833","173","916","917","2006","83789","47","093","47093","2020"
"Census Tract 57.07, Knox County, Tennessee","194","538","533","89","1509","1354","155","1145","209","1509","93654","47","093","47093","2020"
"Census Tract 57.08, Knox County, Tennessee","193","373","411","88","1198","1065","133","840","225","1198","96341","47","093","47093","2020"
"Census Tract 57.09, Knox County, Tennessee","117","433","345","51","1039","946","93","748","198","1039","99167","47","093","47093","2020"
"Census Tract 57.10, Knox County, Tennessee","271","244","416","42","1039","973","66","953","20","1039","169792","47","093","47093","2020"
"Census Tract 57.11, Knox County, Tennessee","325","993","639","148","2158","2105","53","1953","152","2158","105953","47","093","47093","2020"
"Census Tract 57.13, Knox County, Tennessee","232","546","662","74","1565","1514","51","1314","200","1565","111186","47","093","47093","2020"
"Census Tract 57.14, Knox County, Tennessee","383","816","609","92","2059","1900","159","1459","441","2059","109355","47","093","47093","2020"
"Census Tract 58.03, Knox County, Tennessee","326","372","413","188","1320","1299","21","984","315","1320","98250","47","093","47093","2020"
"Census Tract 58.07, Knox County, Tennessee","167","387","428","37","1053","1019","34","909","110","1053","112292","47","093","47093","2020"
"Census Tract 58.08, Knox County, Tennessee","427","783","974","101","2358","2285","73","1843","442","2358","81172","47","093","47093","2020"
"Census Tract 58.09, Knox County, Tennessee","571","744","606","110","2088","2031","57","1692","339","2088","98878","47","093","47093","2020"
"Census Tract 58.10, Knox County, Tennessee","362","405","411","109","1296","1287","9","1202","85","1296","141719","47","093","47093","2020"
"Census Tract 9753, Smith County, Tennessee","252","172","269","13","983","706","277","576","130","983","53438","47","159","47159","2020"
"Census Tract 9754, Smith County, Tennessee","428","655","606","133","2053","1822","231","1380","442","2053","49276","47","159","47159","2020"
"Census Tract 1102.01, Stewart County, Tennessee","697","744","403","17","2244","1861","383","1345","516","2244","57599","47","161","47161","2020"
"Census Tract 1102.02, Stewart County, Tennessee","251","134","262","52","799","699","100","526","173","799","42934","47","161","47161","2020"
"Census Tract 1106, Stewart County, Tennessee","336","336","275","24","1330","971","359","814","157","1330","50493","47","161","47161","2020"
"Census Tract 1107, Stewart County, Tennessee","643","567","418","67","2509","1695","814","1268","427","2509","44719","47","161","47161","2020"
"Census Tract 9801, Stewart County, Tennessee","0","0","0","0","0","0","0","0","0","0","-666666666","47","161","47161","2020"
"Census Tract 9802, Stewart County, Tennessee","0","0","0","0","0","0","0","0","0","0","-666666666","47","161","47161","2020"
"Census Tract 402, Sullivan County, Tennessee","576","454","123","14","1346","1167","179","404","763","1346","27260","47","163","47163","2020"
"Census Tract 403, Sullivan County, Tennessee","550","585","193","4","1470","1332","138","808","524","1470","39861","47","163","47163","2020"
"Census Tract 405, Sullivan County, Tennessee","820","478","450","73","2279","1821","458","903","918","2279","32176","47","163","47163","2020"
"Census Tract 406, Sullivan County, Tennessee","573","526","179","59","1737","1337","400","545","792","1737","24330","47","163","47163","2020"
"Census Tract 407, Sullivan County, Tennessee","614","377","200","52","1359","1243","116","845","398","1359","34635","47","163","47163","2020"
"Census Tract 408, Sullivan County, Tennessee","656","828","209","47","1959","1740","219","961","779","1959","35568","47","163","47163","2020"
"Census Tract 409, Sullivan County, Tennessee","631","527","242","41","1569","1441","128","1105","336","1569","57159","47","163","47163","2020"
"Census Tract 410, Sullivan County, Tennessee","394","680","454","154","1835","1682","153","1442","240","1835","77841","47","163","47163","2020"
"Census Tract 411, Sullivan County, Tennessee","386","576","228","40","1419","1230","189","720","510","1419","44531","47","163","47163","2020"
"Census Tract 412, Sullivan County, Tennessee","1250","868","681","145","3151","2944","207","2107","837","3151","53229","47","163","47163","2020"
"Census Tract 413, Sullivan County, Tennessee","649","786","491","70","2215","1996","219","1480","516","2215","48654","47","163","47163","2020"
"Census Tract 414, Sullivan County, Tennessee","651","834","532","69","2572","2086","486","1770","316","2572","43853","47","163","47163","2020"
"Census Tract 415, Sullivan County, Tennessee","403","513","298","59","1361","1273","88","1121","152","1361","68173","47","163","47163","2020"
"Census Tract 416, Sullivan County, Tennessee","562","356","322","23","1312","1263","49","1008","255","1312","44883","47","163","47163","2020"
"Census Tract 417, Sullivan County, Tennessee","580","516","360","22","1605","1478","127","1018","460","1605","40900","47","163","47163","2020"
"Census Tract 418, Sullivan County, Tennessee","869","427","441","61","2295","1798","497","911","887","2295","40439","47","163","47163","2020"
"Census Tract 419, Sullivan County, Tennessee","387","692","237","59","1554","1375","179","1097","278","1554","44954","47","163","47163","2020"
"Census Tract 420, Sullivan County, Tennessee","503","450","373","100","1628","1426","202","974","452","1628","44761","47","163","47163","2020"
"Census Tract 421, Sullivan County, Tennessee","904","980","466","37","2603","2387","216","1573","814","2603","42027","47","163","47163","2020"
"Census Tract 422, Sullivan County, Tennessee","493","330","315","57","1333","1195","138","948","247","1333","56517","47","163","47163","2020"
"Census Tract 423, Sullivan County, Tennessee","831","960","852","69","2973","2712","261","2315","397","2973","61799","47","163","47163","2020"
"Census Tract 424, Sullivan County, Tennessee","533","614","362","33","1714","1542","172","1049","493","1714","47955","47","163","47163","2020"
"Census Tract 425, Sullivan County, Tennessee","484","418","301","46","1534","1249","285","1048","201","1534","57337","47","163","47163","2020"
"Census Tract 426, Sullivan County, Tennessee","568","760","387","33","1875","1748","127","1200","548","1875","40000","47","163","47163","2020"
"Census Tract 427.02, Sullivan County, Tennessee","356","209","286","58","1031","909","122","575","334","1031","60313","47","163","47163","2020"
"Census Tract 427.03, Sullivan County, Tennessee","622","638","162","0","1578","1422","156","730","692","1578","31250","47","163","47163","2020"
"Census Tract 427.04, Sullivan County, Tennessee","349","541","173","122","1337","1185","152","480","705","1337","37861","47","163","47163","2020"
"Census Tract 428.01, Sullivan County, Tennessee","381","457","339","22","1307","1199","108","780","419","1307","52853","47","163","47163","2020"
"Census Tract 428.02, Sullivan County, Tennessee","570","637","412","58","1853","1677","176","1061","616","1853","32480","47","163","47163","2020"
"Census Tract 429, Sullivan County, Tennessee","650","549","538","91","2001","1828","173","1550","278","2001","73800","47","163","47163","2020"
"Census Tract 430, Sullivan County, Tennessee","597","841","306","77","2079","1821","258","1598","223","2079","45302","47","163","47163","2020"
"Census Tract 431, Sullivan County, Tennessee","629","319","219","78","1683","1245","438","1123","122","1683","47077","47","163","47163","2020"
"Census Tract 432.01, Sullivan County, Tennessee","633","412","496","35","1704","1576","128","1407","169","1704","61489","47","163","47163","2020"
"Census Tract 432.02, Sullivan County, Tennessee","783","692","282","57","2194","1814","380","1505","309","2194","43427","47","163","47163","2020"
"Census Tract 433.01, Sullivan County, Tennessee","676","724","613","408","2837","2421","416","1950","471","2837","70524","47","163","47163","2020"
"Census Tract 433.02, Sullivan County, Tennessee","850","998","641","73","2784","2562","222","1997","565","2784","44924","47","163","47163","2020"
"Census Tract 434.01, Sullivan County, Tennessee","622","685","790","95","2378","2192","186","1650","542","2378","57500","47","163","47163","2020"
"Census Tract 105, Blount County, Tennessee","637","466","167","39","1445","1309","136","635","674","1445","35625","47","009","47009","2020"
"Census Tract 106, Blount County, Tennessee","414","591","286","73","1490","1364","126","729","635","1490","46597","47","009","47009","2020"
"Census Tract 107, Blount County, Tennessee","362","646","528","187","1869","1723","146","1191","532","1869","67533","47","009","47009","2020"
"Census Tract 108, Blount County, Tennessee","445","453","310","65","1414","1273","141","628","645","1414","26773","47","009","47009","2020"
"Census Tract 109, Blount County, Tennessee","851","928","494","232","2720","2505","215","2161","344","2720","65956","47","009","47009","2020"
"Census Tract 110.01, Blount County, Tennessee","820","633","873","27","2695","2353","342","1850","503","2695","70359","47","009","47009","2020"
"Census Tract 110.02, Blount County, Tennessee","557","726","448","82","1896","1813","83","1640","173","1896","75017","47","009","47009","2020"
"Census Tract 111.01, Blount County, Tennessee","402","715","769","114","2153","2000","153","1674","326","2153","70438","47","009","47009","2020"
"Census Tract 111.02, Blount County, Tennessee","1435","1015","945","170","3742","3565","177","2862","703","3742","74835","47","009","47009","2020"
"Census Tract 112.01, Blount County, Tennessee","656","799","488","152","2437","2095","342","1188","907","2437","50033","47","009","47009","2020"
"Census Tract 112.02, Blount County, Tennessee","427","578","534","14","1751","1553","198","1014","539","1751","58468","47","009","47009","2020"
"Census Tract 113.01, Blount County, Tennessee","626","742","600","205","2235","2173","62","1814","359","2235","67188","47","009","47009","2020"
"Census Tract 113.02, Blount County, Tennessee","469","777","663","244","2403","2153","250","1892","261","2403","73542","47","009","47009","2020"
"Census Tract 114.01, Blount County, Tennessee","358","323","127","14","1303","822","481","566","256","1303","43889","47","009","47009","2020"
"Census Tract 114.03, Blount County, Tennessee","241","388","249","5","1103","883","220","741","142","1103","51598","47","009","47009","2020"
"Census Tract 114.04, Blount County, Tennessee","390","284","199","10","1958","883","1075","781","102","1958","56921","47","009","47009","2020"
"Census Tract 115.01, Blount County, Tennessee","275","236","144","34","875","689","186","632","57","875","50532","47","009","47009","2020"
"Census Tract 115.02, Blount County, Tennessee","546","544","436","76","1917","1602","315","1400","202","1917","54050","47","009","47009","2020"
"Census Tract 115.03, Blount County, Tennessee","1020","786","673","269","2938","2748","190","2455","293","2938","70777","47","009","47009","2020"
"Census Tract 116.03, Blount County, Tennessee","497","906","604","105","2379","2112","267","1850","262","2379","57952","47","009","47009","2020"
"Census Tract 116.04, Blount County, Tennessee","452","487","558","95","1708","1592","116","1280","312","1708","72269","47","009","47009","2020"
"Census Tract 116.05, Blount County, Tennessee","534","517","339","59","1715","1449","266","1361","88","1715","83125","47","009","47009","2020"
"Census Tract 116.06, Blount County, Tennessee","585","1112","683","155","2850","2535","315","2256","279","2850","69836","47","009","47009","2020"
"Census Tract 116.07, Blount County, Tennessee","285","557","297","103","1286","1242","44","1006","236","1286","54022","47","009","47009","2020"
"Census Tract 9801, Blount County, Tennessee","0","0","0","0","0","0","0","0","0","0","-666666666","47","009","47009","2020"
"Census Tract 9802, Blount County, Tennessee","9","0","0","0","9","9","0","4","5","9","-666666666","47","009","47009","2020"
"Census Tract 101, Bradley County, Tennessee","634","742","462","133","2116","1971","145","1399","572","2116","46205","47","011","47011","2020"
"Census Tract 102.01, Bradley County, Tennessee","194","492","346","59","1138","1091","47","396","695","1138","47006","47","011","47011","2020"
"Census Tract 102.02, Bradley County, Tennessee","337","425","468","57","1468","1287","181","543","744","1468","45585","47","011","47011","2020"
"Census Tract 103, Bradley County, Tennessee","386","498","395","107","1562","1386","176","443","943","1562","40972","47","011","47011","2020"
"Census Tract 104, Bradley County, Tennessee","286","567","174","32","1210","1059","151","212","847","1210","21904","47","011","47011","2020"
"Census Tract 105, Bradley County, Tennessee","320","411","313","30","1191","1074","117","308","766","1191","37565","47","011","47011","2020"
"Census Tract 106, Bradley County, Tennessee","348","512","404","119","1475","1383","92","694","689","1475","56370","47","011","47011","2020"
"Census Tract 107, Bradley County, Tennessee","589","649","414","76","1912","1728","184","593","1135","1912","35400","47","011","47011","2020"
"Census Tract 108, Bradley County, Tennessee","426","548","146","66","1359","1186","173","368","818","1359","30956","47","011","47011","2020"
"Census Tract 109, Bradley County, Tennessee","307","504","383","42","1389","1236","153","1017","219","1389","54297","47","011","47011","2020"
"Census Tract 110, Bradley County, Tennessee","600","896","647","105","2369","2248","121","1652","596","2369","53445","47","011","47011","2020"
"Census Tract 111.01, Bradley County, Tennessee","464","845","768","119","2312","2196","116","1869","327","2312","69950","47","011","47011","2020"
"Census Tract 111.02, Bradley County, Tennessee","327","314","401","157","1287","1199","88","1086","113","1287","66989","47","011","47011","2020"
"Census Tract 112.01, Bradley County, Tennessee","622","1051","904","87","2856","2664","192","2023","641","2856","54715","47","011","47011","2020"
"Census Tract 112.03, Bradley County, Tennessee","496","535","427","224","1889","1682","207","1467","215","1889","96335","47","011","47011","2020"
"Census Tract 112.04, Bradley County, Tennessee","681","684","619","164","2188","2148","40","1263","885","2188","55301","47","011","47011","2020"
"Census Tract 113.01, Bradley County, Tennessee","667","707","642","103","2228","2119","109","1848","271","2228","57292","47","011","47011","2020"
"Census Tract 113.02, Bradley County, Tennessee","309","201","348","59","1027","917","110","735","182","1027","55479","47","011","47011","2020"
"Census Tract 114.02, Bradley County, Tennessee","255","639","222","121","1336","1237","99","551","686","1336","47865","47","011","47011","2020"
"Census Tract 58.11, Knox County, Tennessee","270","604","460","53","1476","1387","89","1317","70","1476","135511","47","093","47093","2020"
"Census Tract 58.13, Knox County, Tennessee","827","800","876","128","2719","2631","88","2269","362","2719","102642","47","093","47093","2020"
"Census Tract 58.14, Knox County, Tennessee","214","464","579","91","1348","1348","0","1325","23","1348","160962","47","093","47093","2020"
"Census Tract 58.15, Knox County, Tennessee","206","385","287","54","958","932","26","919","13","958","123810","47","093","47093","2020"
"Census Tract 59.03, Knox County, Tennessee","375","541","504","94","1643","1514","129","1235","279","1643","89333","47","093","47093","2020"
"Census Tract 59.06, Knox County, Tennessee","211","256","265","40","816","772","44","692","80","816","104259","47","093","47093","2020"
"Census Tract 59.07, Knox County, Tennessee","368","783","727","140","2238","2018","220","1381","637","2238","102109","47","093","47093","2020"
"Census Tract 59.08, Knox County, Tennessee","449","822","656","92","2110","2019","91","1640","379","2110","60529","47","093","47093","2020"
"Census Tract 59.09, Knox County, Tennessee","61","177","170","72","540","480","60","432","48","540","114375","47","093","47093","2020"
"Census Tract 59.10, Knox County, Tennessee","111","356","284","14","876","765","111","206","559","876","79861","47","093","47093","2020"
"Census Tract 59.11, Knox County, Tennessee","109","351","446","66","1006","972","34","652","320","1006","78750","47","093","47093","2020"
"Census Tract 59.12, Knox County, Tennessee","166","787","564","25","1747","1542","205","1138","404","1747","77206","47","093","47093","2020"
"Census Tract 60.01, Knox County, Tennessee","347","512","596","146","1705","1601","104","997","604","1705","75475","47","093","47093","2020"
"Census Tract 60.02, Knox County, Tennessee","645","974","584","269","2555","2472","83","1995","477","2555","70227","47","093","47093","2020"
"Census Tract 60.03, Knox County, Tennessee","419","555","654","167","1824","1795","29","1578","217","1824","78344","47","093","47093","2020"
"Census Tract 61.02, Knox County, Tennessee","449","666","590","318","2158","2023","135","1516","507","2158","70536","47","093","47093","2020"
"Census Tract 61.03, Knox County, Tennessee","482","522","537","120","1774","1661","113","1268","393","1774","59732","47","093","47093","2020"
"Census Tract 61.04, Knox County, Tennessee","433","1019","614","176","2290","2242","48","1726","516","2290","74184","47","093","47093","2020"
"Census Tract 62.02, Knox County, Tennessee","551","539","583","203","2013","1876","137","1638","238","2013","75458","47","093","47093","2020"
"Census Tract 62.03, Knox County, Tennessee","565","747","584","156","2141","2052","89","1469","583","2141","59444","47","093","47093","2020"
"Census Tract 62.05, Knox County, Tennessee","500","519","578","250","1979","1847","132","1643","204","1979","89608","47","093","47093","2020"
"Census Tract 62.06, Knox County, Tennessee","831","485","817","145","2312","2278","34","1976","302","2312","71304","47","093","47093","2020"
"Census Tract 62.07, Knox County, Tennessee","343","769","419","40","1613","1571","42","970","601","1613","56296","47","093","47093","2020"
"Census Tract 62.08, Knox County, Tennessee","763","615","534","114","2198","2026","172","1522","504","2198","54919","47","093","47093","2020"
"Census Tract 63.01, Knox County, Tennessee","426","354","435","65","1430","1280","150","1014","266","1430","54286","47","093","47093","2020"
"Census Tract 63.02, Knox County, Tennessee","434","403","353","87","1375","1277","98","1077","200","1375","45785","47","093","47093","2020"
"Census Tract 64.01, Knox County, Tennessee","264","571","755","60","1735","1650","85","1493","157","1735","64004","47","093","47093","2020"
"Census Tract 64.02, Knox County, Tennessee","509","556","696","151","1991","1912","79","1739","173","1991","58963","47","093","47093","2020"
"Census Tract 64.03, Knox County, Tennessee","282","399","417","74","1172","1172","0","1006","166","1172","54130","47","093","47093","2020"
"Census Tract 65.01, Knox County, Tennessee","434","442","373","86","1553","1335","218","1049","286","1553","56701","47","093","47093","2020"
"Census Tract 65.02, Knox County, Tennessee","331","699","254","84","1627","1368","259","1023","345","1627","50109","47","093","47093","2020"
"Census Tract 66, Knox County, Tennessee","373","754","379","46","1882","1552","330","572","980","1882","47170","47","093","47093","2020"
"Census Tract 67, Knox County, Tennessee","577","432","363","0","1734","1372","362","526","846","1734","34828","47","093","47093","2020"
"Census Tract 68, Knox County, Tennessee","1267","852","251","98","2983","2468","515","438","2030","2983","16092","47","093","47093","2020"
"Census Tract 69.01, Knox County, Tennessee","506","467","274","90","1502","1337","165","40","1297","1502","22281","47","093","47093","2020"
"Census Tract 69.02, Knox County, Tennessee","103","276","143","67","699","589","110","0","589","699","25719","47","093","47093","2020"
"Census Tract 69.03, Knox County, Tennessee","404","264","218","110","1189","996","193","61","935","1189","21189","47","093","47093","2020"
"Census Tract 70, Knox County, Tennessee","436","265","338","53","1308","1092","216","346","746","1308","23592","47","093","47093","2020"
"Census Tract 71, Knox County, Tennessee","364","764","473","26","1944","1627","317","1085","542","1944","92269","47","093","47093","2020"
"Census Tract 9601, Lake County, Tennessee","654","346","248","19","1587","1267","320","637","630","1587","27831","47","095","47095","2020"
"Census Tract 9602, Lake County, Tennessee","352","347","121","80","1005","900","105","471","429","1005","37431","47","095","47095","2020"
"Census Tract 501, Lauderdale County, Tennessee","180","119","154","14","733","467","266","320","147","733","52625","47","097","47097","2020"
"Census Tract 502, Lauderdale County, Tennessee","520","562","395","0","1652","1477","175","800","677","1652","40213","47","097","47097","2020"
"Census Tract 503, Lauderdale County, Tennessee","354","397","349","71","1346","1171","175","797","374","1346","53420","47","097","47097","2020"
"Census Tract 504, Lauderdale County, Tennessee","385","349","367","50","1366","1151","215","873","278","1366","52736","47","097","47097","2020"
"Census Tract 505.03, Lauderdale County, Tennessee","281","326","309","101","1172","1017","155","694","323","1172","51115","47","097","47097","2020"
"Census Tract 434.02, Sullivan County, Tennessee","559","735","378","113","2015","1785","230","1308","477","2015","46144","47","163","47163","2020"
"Census Tract 435, Sullivan County, Tennessee","489","555","434","68","1836","1546","290","1408","138","1836","56939","47","163","47163","2020"
"Census Tract 436, Sullivan County, Tennessee","600","727","524","147","2203","1998","205","1597","401","2203","66875","47","163","47163","2020"
"Census Tract 201.01, Sumner County, Tennessee","466","404","301","107","1386","1278","108","898","380","1386","52988","47","165","47165","2020"
"Census Tract 201.02, Sumner County, Tennessee","654","604","531","188","2194","1977","217","1430","547","2194","43974","47","165","47165","2020"
"Census Tract 202.03, Sumner County, Tennessee","195","329","274","74","959","872","87","744","128","959","59451","47","165","47165","2020"
"Census Tract 202.04, Sumner County, Tennessee","194","324","524","134","1244","1176","68","998","178","1244","89250","47","165","47165","2020"
"Census Tract 202.05, Sumner County, Tennessee","114","422","413","67","1034","1016","18","810","206","1034","64335","47","165","47165","2020"
"Census Tract 202.06, Sumner County, Tennessee","122","162","235","22","575","541","34","416","125","575","63942","47","165","47165","2020"
"Census Tract 202.07, Sumner County, Tennessee","198","260","216","49","783","723","60","495","228","783","46188","47","165","47165","2020"
"Census Tract 202.08, Sumner County, Tennessee","212","359","292","59","1010","922","88","734","188","1010","61250","47","165","47165","2020"
"Census Tract 202.09, Sumner County, Tennessee","150","254","279","42","819","725","94","646","79","819","70950","47","165","47165","2020"
"Census Tract 203, Sumner County, Tennessee","441","1018","459","117","2230","2035","195","948","1087","2230","33375","47","165","47165","2020"
"Census Tract 204.03, Sumner County, Tennessee","126","306","321","54","874","807","67","707","100","874","82188","47","165","47165","2020"
"Census Tract 204.04, Sumner County, Tennessee","203","293","149","80","845","725","120","614","111","845","63445","47","165","47165","2020"
"Census Tract 204.05, Sumner County, Tennessee","179","289","251","59","810","778","32","560","218","810","62500","47","165","47165","2020"
"Census Tract 204.06, Sumner County, Tennessee","238","431","463","142","1316","1274","42","1142","132","1316","99500","47","165","47165","2020"
"Census Tract 204.07, Sumner County, Tennessee","228","488","789","188","1731","1693","38","1500","193","1731","86738","47","165","47165","2020"
"Census Tract 205.01, Sumner County, Tennessee","794","1164","753","115","3134","2826","308","1902","924","3134","73669","47","165","47165","2020"
"Census Tract 205.02, Sumner County, Tennessee","321","462","937","271","2046","1991","55","1850","141","2046","110703","47","165","47165","2020"
"Census Tract 205.03, Sumner County, Tennessee","338","433","280","53","1148","1104","44","972","132","1148","63564","47","165","47165","2020"
"Census Tract 206.01, Sumner County, Tennessee","353","456","250","202","1373","1261","112","1118","143","1373","68607","47","165","47165","2020"
"Census Tract 206.02, Sumner County, Tennessee","354","686","619","139","1945","1798","147","1608","190","1945","81456","47","165","47165","2020"
"Census Tract 206.03, Sumner County, Tennessee","319","387","430","81","1322","1217","105","1118","99","1322","73205","47","165","47165","2020"
"Census Tract 207, Sumner County, Tennessee","811","843","361","140","2219","2155","64","1136","1019","2219","41592","47","165","47165","2020"
"Census Tract 208, Sumner County, Tennessee","874","897","536","225","2898","2532","366","923","1609","2898","34440","47","165","47165","2020"
"Census Tract 209.01, Sumner County, Tennessee","132","294","136","25","640","587","53","325","262","640","79327","47","165","47165","2020"
"Census Tract 209.03, Sumner County, Tennessee","488","494","517","52","1805","1551","254","1184","367","1805","65179","47","165","47165","2020"
"Census Tract 209.04, Sumner County, Tennessee","427","473","381","146","1502","1427","75","665","762","1502","38313","47","165","47165","2020"
"Census Tract 209.05, Sumner County, Tennessee","379","540","606","0","1576","1525","51","1078","447","1576","51875","47","165","47165","2020"
"Census Tract 210.02, Sumner County, Tennessee","464","919","1014","134","2655","2531","124","1930","601","2655","85727","47","165","47165","2020"
"Census Tract 210.04, Sumner County, Tennessee","216","811","592","173","1825","1792","33","1284","508","1825","59882","47","165","47165","2020"
"Census Tract 210.05, Sumner County, Tennessee","591","503","614","277","2159","1985","174","1577","408","2159","81580","47","165","47165","2020"
"Census Tract 210.06, Sumner County, Tennessee","182","434","508","169","1325","1293","32","1131","162","1325","102827","47","165","47165","2020"
"Census Tract 210.07, Sumner County, Tennessee","117","336","663","81","1237","1197","40","1160","37","1237","124755","47","165","47165","2020"
"Census Tract 210.08, Sumner County, Tennessee","313","756","771","210","2127","2050","77","1784","266","2127","111579","47","165","47165","2020"
"Census Tract 210.09, Sumner County, Tennessee","660","596","701","194","2282","2151","131","1402","749","2282","67099","47","165","47165","2020"
"Census Tract 211.03, Sumner County, Tennessee","324","1175","841","103","2443","2443","0","2066","377","2443","75241","47","165","47165","2020"
"Census Tract 211.04, Sumner County, Tennessee","165","220","230","51","679","666","13","489","177","679","60052","47","165","47165","2020"
"Census Tract 211.05, Sumner County, Tennessee","217","913","860","237","2509","2227","282","1090","1137","2509","63135","47","165","47165","2020"
"Census Tract 211.06, Sumner County, Tennessee","533","698","404","120","1890","1755","135","864","891","1890","57776","47","165","47165","2020"
"Census Tract 211.07, Sumner County, Tennessee","461","1209","676","219","2738","2565","173","1336","1229","2738","65334","47","165","47165","2020"
"Census Tract 212.01, Sumner County, Tennessee","436","758","1079","207","2563","2480","83","2387","93","2563","110026","47","165","47165","2020"
"Census Tract 212.03, Sumner County, Tennessee","622","1249","1003","273","3505","3147","358","2299","848","3505","104081","47","165","47165","2020"
"Census Tract 212.04, Sumner County, Tennessee","659","1092","760","195","2899","2706","193","1873","833","2899","68472","47","165","47165","2020"
"Census Tract 114.03, Bradley County, Tennessee","429","534","597","0","1685","1560","125","1169","391","1685","62760","47","011","47011","2020"
"Census Tract 114.04, Bradley County, Tennessee","674","494","421","103","1799","1692","107","1353","339","1799","58125","47","011","47011","2020"
"Census Tract 115.01, Bradley County, Tennessee","743","896","733","88","2712","2460","252","1817","643","2712","56989","47","011","47011","2020"
"Census Tract 115.02, Bradley County, Tennessee","441","454","480","85","1460","1460","0","1322","138","1460","66702","47","011","47011","2020"
"Census Tract 116.01, Bradley County, Tennessee","573","580","559","60","1993","1772","221","1337","435","1993","55043","47","011","47011","2020"
"Census Tract 116.02, Bradley County, Tennessee","741","504","576","154","2188","1975","213","1747","228","2188","50739","47","011","47011","2020"
"Census Tract 9501, Campbell County, Tennessee","559","537","168","58","1538","1322","216","1099","223","1538","43667","47","013","47013","2020"
"Census Tract 9502, Campbell County, Tennessee","660","190","169","17","1283","1036","247","518","518","1283","26319","47","013","47013","2020"
"Census Tract 9503, Campbell County, Tennessee","210","319","151","52","809","732","77","534","198","809","46643","47","013","47013","2020"
"Census Tract 9504, Campbell County, Tennessee","736","596","470","78","2520","1880","640","1337","543","2520","45231","47","013","47013","2020"
"Census Tract 9505, Campbell County, Tennessee","803","705","591","143","2642","2242","400","1456","786","2642","48300","47","013","47013","2020"
"Census Tract 9506.01, Campbell County, Tennessee","338","312","247","20","1158","917","241","269","648","1158","36659","47","013","47013","2020"
"Census Tract 9506.02, Campbell County, Tennessee","428","333","132","36","1054","929","125","464","465","1054","34066","47","013","47013","2020"
"Census Tract 9507.01, Campbell County, Tennessee","197","330","141","36","938","704","234","469","235","938","54737","47","013","47013","2020"
"Census Tract 9507.02, Campbell County, Tennessee","598","336","146","143","1344","1223","121","541","682","1344","32202","47","013","47013","2020"
"Census Tract 9508, Campbell County, Tennessee","503","293","229","0","1242","1025","217","860","165","1242","42813","47","013","47013","2020"
"Census Tract 9509, Campbell County, Tennessee","552","418","246","34","2071","1250","821","919","331","2071","40539","47","013","47013","2020"
"Census Tract 9510, Campbell County, Tennessee","525","326","130","44","1541","1025","516","746","279","1541","32188","47","013","47013","2020"
"Census Tract 9511, Campbell County, Tennessee","539","747","775","115","3067","2176","891","1722","454","3067","55303","47","013","47013","2020"
"Census Tract 9601, Cannon County, Tennessee","593","544","439","68","1814","1644","170","1282","362","1814","52750","47","015","47015","2020"
"Census Tract 9602.01, Cannon County, Tennessee","204","441","188","12","908","845","63","458","387","908","45550","47","015","47015","2020"
"Census Tract 9602.02, Cannon County, Tennessee","487","577","469","56","1865","1589","276","1270","319","1865","57639","47","015","47015","2020"
"Census Tract 9603, Cannon County, Tennessee","484","497","414","106","1578","1501","77","1275","226","1578","55771","47","015","47015","2020"
"Census Tract 9620, Carroll County, Tennessee","779","546","400","64","2216","1789","427","1338","451","2216","34067","47","017","47017","2020"
"Census Tract 9621.01, Carroll County, Tennessee","368","347","261","7","1171","983","188","674","309","1171","43142","47","017","47017","2020"
"Census Tract 9621.02, Carroll County, Tennessee","520","415","277","111","1655","1323","332","890","433","1655","38133","47","017","47017","2020"
"Census Tract 9622.01, Carroll County, Tennessee","534","483","212","27","1495","1256","239","858","398","1495","36417","47","017","47017","2020"
"Census Tract 9622.02, Carroll County, Tennessee","550","650","469","122","2076","1791","285","1180","611","2076","52679","47","017","47017","2020"
"Census Tract 9623, Carroll County, Tennessee","660","687","441","112","2278","1900","378","1568","332","2278","46481","47","017","47017","2020"
"Census Tract 9624, Carroll County, Tennessee","358","310","280","132","1266","1080","186","898","182","1266","51574","47","017","47017","2020"
"Census Tract 9625, Carroll County, Tennessee","351","297","165","58","1099","871","228","688","183","1099","40156","47","017","47017","2020"
"Census Tract 9801, Carroll County, Tennessee","0","0","0","0","0","0","0","0","0","0","-666666666","47","017","47017","2020"
"Census Tract 701, Carter County, Tennessee","446","182","127","21","940","776","164","455","321","940","29931","47","019","47019","2020"
"Census Tract 702, Carter County, Tennessee","501","490","408","83","1631","1482","149","884","598","1631","45357","47","019","47019","2020"
"Census Tract 703, Carter County, Tennessee","752","1084","391","102","2490","2329","161","1562","767","2490","38803","47","019","47019","2020"
"Census Tract 704, Carter County, Tennessee","343","298","173","0","936","814","122","564","250","936","39483","47","019","47019","2020"
"Census Tract 705, Carter County, Tennessee","593","685","349","94","2108","1721","387","1405","316","2108","47138","47","019","47019","2020"
"Census Tract 706, Carter County, Tennessee","392","430","316","11","1297","1149","148","808","341","1297","36377","47","019","47019","2020"
"Census Tract 707, Carter County, Tennessee","613","531","394","100","1844","1638","206","1222","416","1844","41675","47","019","47019","2020"
"Census Tract 708, Carter County, Tennessee","587","439","237","123","1492","1386","106","825","561","1492","45357","47","019","47019","2020"
"Census Tract 709, Carter County, Tennessee","454","505","386","41","1563","1386","177","772","614","1563","42500","47","019","47019","2020"
"Census Tract 710, Carter County, Tennessee","617","462","180","22","1523","1281","242","883","398","1523","24453","47","019","47019","2020"
"Census Tract 711, Carter County, Tennessee","346","231","138","31","849","746","103","653","93","849","45571","47","019","47019","2020"
"Census Tract 712, Carter County, Tennessee","681","706","259","68","1999","1714","285","991","723","1999","41692","47","019","47019","2020"
"Census Tract 713.01, Carter County, Tennessee","659","517","490","30","1899","1696","203","1320","376","1899","50200","47","019","47019","2020"
"Census Tract 505.04, Lauderdale County, Tennessee","369","452","119","27","1140","967","173","387","580","1140","32684","47","097","47097","2020"
"Census Tract 505.05, Lauderdale County, Tennessee","719","563","133","78","1761","1493","268","432","1061","1761","34884","47","097","47097","2020"
"Census Tract 505.06, Lauderdale County, Tennessee","314","330","232","29","1039","905","134","629","276","1039","52330","47","097","47097","2020"
"Census Tract 506, Lauderdale County, Tennessee","432","346","170","13","1134","961","173","535","426","1134","34375","47","097","47097","2020"
"Census Tract 9601, Lawrence County, Tennessee","614","529","294","108","1811","1545","266","1208","337","1811","48341","47","099","47099","2020"
"Census Tract 9602, Lawrence County, Tennessee","528","360","228","59","1284","1175","109","1091","84","1284","44375","47","099","47099","2020"
"Census Tract 9603, Lawrence County, Tennessee","521","606","435","163","1998","1725","273","1330","395","1998","46069","47","099","47099","2020"
"Census Tract 9604.01, Lawrence County, Tennessee","1050","743","324","80","2424","2197","227","1566","631","2424","38906","47","099","47099","2020"
"Census Tract 9604.02, Lawrence County, Tennessee","327","885","363","147","1894","1722","172","1260","462","1894","63838","47","099","47099","2020"
"Census Tract 9605.01, Lawrence County, Tennessee","837","579","272","30","1944","1718","226","822","896","1944","29132","47","099","47099","2020"
"Census Tract 9605.02, Lawrence County, Tennessee","562","421","482","100","1727","1565","162","1249","316","1727","38899","47","099","47099","2020"
"Census Tract 9606, Lawrence County, Tennessee","417","274","195","17","1075","903","172","713","190","1075","39095","47","099","47099","2020"
"Census Tract 9607, Lawrence County, Tennessee","588","497","331","77","1690","1493","197","1259","234","1690","50255","47","099","47099","2020"
"Census Tract 9608, Lawrence County, Tennessee","411","550","313","72","1532","1346","186","1040","306","1532","46048","47","099","47099","2020"
"Census Tract 9609, Lawrence County, Tennessee","320","201","215","15","877","751","126","595","156","877","41940","47","099","47099","2020"
"Census Tract 9701, Lewis County, Tennessee","762","576","413","88","2117","1839","278","1610","229","2117","43396","47","101","47101","2020"
"Census Tract 9702, Lewis County, Tennessee","1297","824","693","184","3481","2998","483","2180","818","3481","34654","47","101","47101","2020"
"Census Tract 9750, Lincoln County, Tennessee","244","297","160","61","954","762","192","644","118","954","63125","47","103","47103","2020"
"Census Tract 9751, Lincoln County, Tennessee","244","387","339","40","1089","1010","79","858","152","1089","53333","47","103","47103","2020"
"Census Tract 9752, Lincoln County, Tennessee","240","214","187","60","896","701","195","644","57","896","63264","47","103","47103","2020"
"Census Tract 9753, Lincoln County, Tennessee","915","1120","473","147","2995","2655","340","1512","1143","2995","44141","47","103","47103","2020"
"Census Tract 9754, Lincoln County, Tennessee","602","757","329","83","1979","1771","208","1186","585","1979","44301","47","103","47103","2020"
"Census Tract 9755, Lincoln County, Tennessee","498","693","526","39","2206","1756","450","1438","318","2206","50521","47","103","47103","2020"
"Census Tract 9756.01, Lincoln County, Tennessee","456","708","832","230","2283","2226","57","1860","366","2283","73750","47","103","47103","2020"
"Census Tract 9756.02, Lincoln County, Tennessee","498","566","339","111","1652","1514","138","1252","262","1652","53912","47","103","47103","2020"
"Census Tract 9757, Lincoln County, Tennessee","478","386","465","64","1570","1393","177","1203","190","1570","63378","47","103","47103","2020"
"Census Tract 601, Loudon County, Tennessee","501","613","619","136","2060","1869","191","1576","293","2060","53277","47","105","47105","2020"
"Census Tract 602.01, Loudon County, Tennessee","406","398","684","158","1663","1646","17","1291","355","1663","62033","47","105","47105","2020"
"Census Tract 602.03, Loudon County, Tennessee","384","423","237","41","1240","1085","155","536","549","1240","31157","47","105","47105","2020"
"Census Tract 602.04, Loudon County, Tennessee","768","762","434","136","2331","2100","231","1209","891","2331","40789","47","105","47105","2020"
"Census Tract 603.01, Loudon County, Tennessee","573","652","370","147","1958","1742","216","1309","433","1958","75000","47","105","47105","2020"
"Census Tract 603.03, Loudon County, Tennessee","346","417","553","112","1566","1428","138","1217","211","1566","73073","47","105","47105","2020"
"Census Tract 603.04, Loudon County, Tennessee","373","378","445","20","1216","1216","0","1115","101","1216","71087","47","105","47105","2020"
"Census Tract 604, Loudon County, Tennessee","544","610","704","78","2193","1936","257","1648","288","2193","70192","47","105","47105","2020"
"Census Tract 605.02, Loudon County, Tennessee","285","188","334","62","1052","869","183","696","173","1052","59659","47","105","47105","2020"
"Census Tract 605.03, Loudon County, Tennessee","781","263","374","49","1693","1467","226","1268","199","1693","47882","47","105","47105","2020"
"Census Tract 605.04, Loudon County, Tennessee","1654","268","51","14","2340","1987","353","1955","32","2340","68553","47","105","47105","2020"
"Census Tract 605.05, Loudon County, Tennessee","740","93","14","0","892","847","45","847","0","892","99599","47","105","47105","2020"
"Census Tract 606, Loudon County, Tennessee","591","525","560","168","2095","1844","251","1223","621","2095","56286","47","105","47105","2020"
"Census Tract 607, Loudon County, Tennessee","341","259","247","84","1094","931","163","735","196","1094","63828","47","105","47105","2020"
"Census Tract 9701.02, McMinn County, Tennessee","602","880","427","148","2296","2057","239","1647","410","2296","49660","47","107","47107","2020"
"Census Tract 9701.03, McMinn County, Tennessee","281","431","307","127","1456","1146","310","1009","137","1456","55779","47","107","47107","2020"
"Census Tract 9701.04, McMinn County, Tennessee","352","470","328","77","1272","1227","45","1038","189","1272","58342","47","107","47107","2020"
"Census Tract 9702.01, McMinn County, Tennessee","464","454","152","0","1131","1070","61","265","805","1131","31880","47","107","47107","2020"
"Census Tract 9702.02, McMinn County, Tennessee","718","660","218","51","1736","1647","89","826","821","1736","33644","47","107","47107","2020"
"Census Tract 212.05, Sumner County, Tennessee","375","415","293","67","1168","1150","18","1099","51","1168","102850","47","165","47165","2020"
"Census Tract 401, Tipton County, Tennessee","437","721","548","99","2036","1805","231","1170","635","2036","50216","47","167","47167","2020"
"Census Tract 402, Tipton County, Tennessee","211","311","197","14","847","733","114","581","152","847","46641","47","167","47167","2020"
"Census Tract 403.02, Tipton County, Tennessee","629","1026","1526","180","3666","3361","305","2767","594","3666","88852","47","167","47167","2020"
"Census Tract 403.03, Tipton County, Tennessee","489","746","1102","67","2584","2404","180","1819","585","2584","69601","47","167","47167","2020"
"Census Tract 403.04, Tipton County, Tennessee","531","800","529","243","2259","2103","156","1632","471","2259","67435","47","167","47167","2020"
"Census Tract 404, Tipton County, Tennessee","374","316","308","58","1221","1056","165","923","133","1221","46830","47","167","47167","2020"
"Census Tract 405, Tipton County, Tennessee","476","987","652","89","2439","2204","235","1759","445","2439","61474","47","167","47167","2020"
"Census Tract 406.01, Tipton County, Tennessee","518","596","574","20","1850","1708","142","1203","505","1850","51096","47","167","47167","2020"
"Census Tract 406.02, Tipton County, Tennessee","327","531","278","94","1316","1230","86","772","458","1316","52109","47","167","47167","2020"
"Census Tract 407, Tipton County, Tennessee","741","876","452","34","2383","2103","280","888","1215","2383","28286","47","167","47167","2020"
"Census Tract 408, Tipton County, Tennessee","355","508","351","264","1555","1478","77","1261","217","1555","86531","47","167","47167","2020"
"Census Tract 409, Tipton County, Tennessee","146","205","158","100","690","609","81","528","81","690","60938","47","167","47167","2020"
"Census Tract 410, Tipton County, Tennessee","211","383","190","46","1091","830","261","623","207","1091","51765","47","167","47167","2020"
"Census Tract 901, Trousdale County, Tennessee","581","1006","657","138","2584","2382","202","1900","482","2584","60615","47","169","47169","2020"
"Census Tract 902, Trousdale County, Tennessee","267","483","259","7","1101","1016","85","632","384","1101","50313","47","169","47169","2020"
"Census Tract 801, Unicoi County, Tennessee","383","450","148","38","1430","1019","411","803","216","1430","56875","47","171","47171","2020"
"Census Tract 802, Unicoi County, Tennessee","925","1164","463","149","2963","2701","262","1959","742","2963","45076","47","171","47171","2020"
"Census Tract 803, Unicoi County, Tennessee","850","700","535","129","2473","2214","259","1577","637","2473","44196","47","171","47171","2020"
"Census Tract 804, Unicoi County, Tennessee","829","583","259","78","2048","1749","299","1234","515","2048","40680","47","171","47171","2020"
"Census Tract 401.01, Union County, Tennessee","612","618","282","142","1889","1654","235","1265","389","1889","40255","47","173","47173","2020"
"Census Tract 401.02, Union County, Tennessee","388","486","217","28","1413","1119","294","960","159","1413","37309","47","173","47173","2020"
"Census Tract 402.01, Union County, Tennessee","574","385","476","116","1796","1551","245","1061","490","1796","44099","47","173","47173","2020"
"Census Tract 402.02, Union County, Tennessee","783","745","480","154","2717","2162","555","1595","567","2717","53981","47","173","47173","2020"
"Census Tract 403, Union County, Tennessee","458","230","228","61","1672","977","695","740","237","1672","57679","47","173","47173","2020"
"Census Tract 9250, Van Buren County, Tennessee","416","287","319","54","1276","1076","200","916","160","1276","41667","47","175","47175","2020"
"Census Tract 9252, Van Buren County, Tennessee","372","419","320","55","1421","1166","255","877","289","1421","48944","47","175","47175","2020"
"Census Tract 9301, Warren County, Tennessee","456","335","491","66","1666","1348","318","1189","159","1666","40948","47","177","47177","2020"
"Census Tract 9302.01, Warren County, Tennessee","245","414","215","157","1279","1031","248","773","258","1279","47429","47","177","47177","2020"
"Census Tract 9302.02, Warren County, Tennessee","342","592","431","88","1619","1453","166","1060","393","1619","50748","47","177","47177","2020"
"Census Tract 9303, Warren County, Tennessee","312","407","240","38","1118","997","121","822","175","1118","54867","47","177","47177","2020"
"Census Tract 9304, Warren County, Tennessee","746","922","516","102","2786","2286","500","1173","1113","2786","39399","47","177","47177","2020"
"Census Tract 9305, Warren County, Tennessee","810","715","294","75","2113","1894","219","1083","811","2113","31371","47","177","47177","2020"
"Census Tract 9306, Warren County, Tennessee","624","534","285","126","1887","1569","318","857","712","1887","40266","47","177","47177","2020"
"Census Tract 9307, Warren County, Tennessee","493","753","458","162","2014","1866","148","1321","545","2014","50880","47","177","47177","2020"
"Census Tract 9308, Warren County, Tennessee","813","803","408","310","2654","2334","320","2017","317","2654","43365","47","177","47177","2020"
"Census Tract 9309, Warren County, Tennessee","272","217","232","16","882","737","145","607","130","882","44148","47","177","47177","2020"
"Census Tract 601, Washington County, Tennessee","635","700","234","60","2012","1629","383","345","1284","2012","19443","47","179","47179","2020"
"Census Tract 604.01, Washington County, Tennessee","307","332","237","19","1032","895","137","700","195","1032","58015","47","179","47179","2020"
"Census Tract 604.02, Washington County, Tennessee","513","644","456","61","1962","1674","288","946","728","1962","73202","47","179","47179","2020"
"Census Tract 605.01, Washington County, Tennessee","682","840","323","194","2411","2039","372","1226","813","2411","32561","47","179","47179","2020"
"Census Tract 605.03, Washington County, Tennessee","320","333","360","9","1094","1022","72","787","235","1094","41688","47","179","47179","2020"
"Census Tract 605.04, Washington County, Tennessee","427","571","542","97","1833","1637","196","655","982","1833","40545","47","179","47179","2020"
"Census Tract 606.01, Washington County, Tennessee","471","692","485","17","1712","1665","47","1153","512","1712","43633","47","179","47179","2020"
"Census Tract 606.02, Washington County, Tennessee","651","696","295","61","1889","1703","186","410","1293","1889","24096","47","179","47179","2020"
"Census Tract 713.02, Carter County, Tennessee","436","509","486","86","1748","1517","231","1196","321","1748","43301","47","019","47019","2020"
"Census Tract 714, Carter County, Tennessee","639","428","331","26","1707","1424","283","1143","281","1707","38906","47","019","47019","2020"
"Census Tract 715, Carter County, Tennessee","490","194","147","14","1131","845","286","759","86","1131","33924","47","019","47019","2020"
"Census Tract 716, Carter County, Tennessee","349","224","138","19","1176","730","446","611","119","1176","34432","47","019","47019","2020"
"Census Tract 717, Carter County, Tennessee","402","518","373","66","1903","1359","544","1216","143","1903","43934","47","019","47019","2020"
"Census Tract 701.02, Cheatham County, Tennessee","369","476","417","139","1624","1401","223","1133","268","1624","70614","47","021","47021","2020"
"Census Tract 701.03, Cheatham County, Tennessee","292","450","428","181","1466","1351","115","968","383","1466","62125","47","021","47021","2020"
"Census Tract 701.04, Cheatham County, Tennessee","722","1022","378","218","2461","2340","121","1528","812","2461","42388","47","021","47021","2020"
"Census Tract 702.01, Cheatham County, Tennessee","271","586","667","180","1725","1704","21","1344","360","1725","86270","47","021","47021","2020"
"Census Tract 702.02, Cheatham County, Tennessee","374","964","683","118","2286","2139","147","1853","286","2286","56190","47","021","47021","2020"
"Census Tract 702.03, Cheatham County, Tennessee","289","579","500","81","1627","1449","178","1254","195","1627","63386","47","021","47021","2020"
"Census Tract 703, Cheatham County, Tennessee","420","362","412","124","1511","1318","193","726","592","1511","60909","47","021","47021","2020"
"Census Tract 704.01, Cheatham County, Tennessee","254","245","381","114","1082","994","88","816","178","1082","71467","47","021","47021","2020"
"Census Tract 704.02, Cheatham County, Tennessee","643","813","922","243","2677","2621","56","2241","380","2677","77383","47","021","47021","2020"
"Census Tract 9701.01, Chester County, Tennessee","171","364","451","10","1192","996","196","964","32","1192","71623","47","023","47023","2020"
"Census Tract 9701.02, Chester County, Tennessee","461","365","392","23","1454","1241","213","1084","157","1454","55589","47","023","47023","2020"
"Census Tract 9702, Chester County, Tennessee","672","706","300","64","1965","1742","223","1018","724","1965","43629","47","023","47023","2020"
"Census Tract 9703.01, Chester County, Tennessee","273","71","167","19","693","530","163","459","71","693","47115","47","023","47023","2020"
"Census Tract 9703.02, Chester County, Tennessee","560","387","414","122","1862","1483","379","1099","384","1862","48040","47","023","47023","2020"
"Census Tract 9701, Claiborne County, Tennessee","491","434","333","0","1358","1258","100","821","437","1358","35625","47","025","47025","2020"
"Census Tract 9702, Claiborne County, Tennessee","463","384","280","45","1381","1172","209","871","301","1381","50000","47","025","47025","2020"
"Census Tract 9703, Claiborne County, Tennessee","661","603","254","126","1836","1644","192","1055","589","1836","36593","47","025","47025","2020"
"Census Tract 9704, Claiborne County, Tennessee","191","33","77","10","371","311","60","287","24","371","28018","47","025","47025","2020"
"Census Tract 9705, Claiborne County, Tennessee","661","276","264","27","1449","1228","221","955","273","1449","32381","47","025","47025","2020"
"Census Tract 9706, Claiborne County, Tennessee","724","524","476","223","2329","1947","382","1703","244","2329","45907","47","025","47025","2020"
"Census Tract 9707, Claiborne County, Tennessee","1121","869","521","112","2793","2623","170","1640","983","2793","36555","47","025","47025","2020"
"Census Tract 9708, Claiborne County, Tennessee","580","527","383","58","1779","1548","231","1253","295","1779","40039","47","025","47025","2020"
"Census Tract 9709, Claiborne County, Tennessee","752","625","350","103","2243","1830","413","1023","807","2243","33750","47","025","47025","2020"
"Census Tract 9550, Clay County, Tennessee","1082","537","429","87","2994","2135","859","1579","556","2994","31340","47","027","47027","2020"
"Census Tract 9551, Clay County, Tennessee","372","384","274","11","1373","1041","332","894","147","1373","40966","47","027","47027","2020"
"Census Tract 9201, Cocke County, Tennessee","674","429","400","73","1923","1576","347","1192","384","1923","42983","47","029","47029","2020"
"Census Tract 9202, Cocke County, Tennessee","752","910","358","170","2820","2190","630","1357","833","2820","34358","47","029","47029","2020"
"Census Tract 9203, Cocke County, Tennessee","637","711","401","56","2069","1805","264","1451","354","2069","55244","47","029","47029","2020"
"Census Tract 9204, Cocke County, Tennessee","425","197","185","9","1088","816","272","656","160","1088","34125","47","029","47029","2020"
"Census Tract 9205.01, Cocke County, Tennessee","814","1156","426","38","2895","2434","461","1442","992","2895","31250","47","029","47029","2020"
"Census Tract 9205.02, Cocke County, Tennessee","657","713","588","105","2325","2063","262","1507","556","2325","52344","47","029","47029","2020"
"Census Tract 9206, Cocke County, Tennessee","758","521","321","31","2209","1631","578","1085","546","2209","35387","47","029","47029","2020"
"Census Tract 9207, Cocke County, Tennessee","652","624","304","76","2311","1656","655","1174","482","2311","39667","47","029","47029","2020"
"Census Tract 9801, Cocke County, Tennessee","0","0","0","0","0","0","0","0","0","0","-666666666","47","029","47029","2020"
"Census Tract 9701, Coffee County, Tennessee","367","460","420","112","1530","1359","171","1121","238","1530","58089","47","031","47031","2020"
"Census Tract 9702.01, Coffee County, Tennessee","395","362","744","26","1790","1527","263","1332","195","1790","41561","47","031","47031","2020"
"Census Tract 9702.02, Coffee County, Tennessee","602","584","310","129","1832","1625","207","1035","590","1832","53872","47","031","47031","2020"
"Census Tract 9703, Coffee County, Tennessee","195","179","169","87","780","630","150","486","144","780","56500","47","031","47031","2020"
"Census Tract 9704.01, Coffee County, Tennessee","275","213","136","9","711","633","78","480","153","711","73250","47","031","47031","2020"
"Census Tract 9704.02, Coffee County, Tennessee","450","700","567","166","2045","1883","162","1192","691","2045","46498","47","031","47031","2020"
"Census Tract 9703, McMinn County, Tennessee","546","434","319","81","1439","1380","59","888","492","1439","37721","47","107","47107","2020"
"Census Tract 9704.01, McMinn County, Tennessee","494","784","285","104","1755","1667","88","1261","406","1755","52418","47","107","47107","2020"
"Census Tract 9704.02, McMinn County, Tennessee","647","676","439","129","2126","1891","235","1595","296","2126","51722","47","107","47107","2020"
"Census Tract 9705, McMinn County, Tennessee","596","673","320","115","1840","1704","136","1281","423","1840","40909","47","107","47107","2020"
"Census Tract 9706.01, McMinn County, Tennessee","457","454","211","61","1293","1183","110","943","240","1293","64331","47","107","47107","2020"
"Census Tract 9706.02, McMinn County, Tennessee","522","371","401","0","1514","1294","220","1045","249","1514","44500","47","107","47107","2020"
"Census Tract 9707, McMinn County, Tennessee","719","613","288","116","2112","1736","376","1335","401","2112","42839","47","107","47107","2020"
"Census Tract 9708.01, McMinn County, Tennessee","459","581","549","39","1780","1628","152","1411","217","1780","51441","47","107","47107","2020"
"Census Tract 9708.02, McMinn County, Tennessee","454","469","375","219","1708","1517","191","1167","350","1708","54532","47","107","47107","2020"
"Census Tract 9301, McNairy County, Tennessee","675","458","275","94","1945","1502","443","1151","351","1945","37692","47","109","47109","2020"
"Census Tract 9302, McNairy County, Tennessee","417","312","140","88","1182","957","225","833","124","1182","37721","47","109","47109","2020"
"Census Tract 9303, McNairy County, Tennessee","425","383","199","27","1426","1034","392","866","168","1426","40625","47","109","47109","2020"
"Census Tract 9304, McNairy County, Tennessee","332","246","117","24","799","719","80","485","234","799","38125","47","109","47109","2020"
"Census Tract 9305.01, McNairy County, Tennessee","398","285","309","0","1157","992","165","655","337","1157","40714","47","109","47109","2020"
"Census Tract 9305.02, McNairy County, Tennessee","928","799","297","36","2277","2060","217","1439","621","2277","32173","47","109","47109","2020"
"Census Tract 9306, McNairy County, Tennessee","516","489","369","65","1735","1439","296","1151","288","1735","48482","47","109","47109","2020"
"Census Tract 9307, McNairy County, Tennessee","478","337","263","94","1545","1172","373","945","227","1545","45417","47","109","47109","2020"
"Census Tract 9701, Macon County, Tennessee","759","626","409","59","2226","1853","373","1317","536","2226","32861","47","111","47111","2020"
"Census Tract 9702, Macon County, Tennessee","557","663","872","105","2476","2197","279","1849","348","2476","70941","47","111","47111","2020"
"Census Tract 9703.01, Macon County, Tennessee","561","776","388","58","1914","1783","131","1118","665","1914","28960","47","111","47111","2020"
"Census Tract 9703.02, Macon County, Tennessee","413","761","393","63","1875","1630","245","1186","444","1875","34627","47","111","47111","2020"
"Census Tract 9704, Macon County, Tennessee","391","639","485","165","1982","1680","302","1237","443","1982","54926","47","111","47111","2020"
"Census Tract 1, Madison County, Tennessee","613","667","314","33","1770","1627","143","861","766","1770","43984","47","113","47113","2020"
"Census Tract 2, Madison County, Tennessee","729","1340","583","47","3239","2699","540","1138","1561","3239","37740","47","113","47113","2020"
"Census Tract 3, Madison County, Tennessee","638","699","411","99","2147","1847","300","1023","824","2147","47228","47","113","47113","2020"
"Census Tract 4, Madison County, Tennessee","580","489","248","67","1529","1384","145","485","899","1529","34605","47","113","47113","2020"
"Census Tract 5, Madison County, Tennessee","578","649","187","27","1637","1441","196","237","1204","1637","18491","47","113","47113","2020"
"Census Tract 6, Madison County, Tennessee","294","296","216","13","1019","819","200","312","507","1019","29792","47","113","47113","2020"
"Census Tract 7, Madison County, Tennessee","398","445","103","25","1480","971","509","275","696","1480","23472","47","113","47113","2020"
"Census Tract 8, Madison County, Tennessee","346","156","60","21","717","583","134","121","462","717","19628","47","113","47113","2020"
"Census Tract 9, Madison County, Tennessee","533","321","111","35","1259","1000","259","408","592","1259","21594","47","113","47113","2020"
"Census Tract 10, Madison County, Tennessee","441","290","134","6","1103","871","232","318","553","1103","28897","47","113","47113","2020"
"Census Tract 11, Madison County, Tennessee","184","169","13","17","446","383","63","112","271","446","18839","47","113","47113","2020"
"Census Tract 13, Madison County, Tennessee","913","876","659","17","2686","2465","221","1670","795","2686","41173","47","113","47113","2020"
"Census Tract 14.01, Madison County, Tennessee","278","177","184","79","851","718","133","502","216","851","40000","47","113","47113","2020"
"Census Tract 14.02, Madison County, Tennessee","448","228","351","54","1166","1081","85","843","238","1166","52168","47","113","47113","2020"
"Census Tract 15.01, Madison County, Tennessee","297","967","576","142","2031","1982","49","1423","559","2031","55539","47","113","47113","2020"
"Census Tract 15.02, Madison County, Tennessee","909","608","581","157","2576","2255","321","2128","127","2576","68338","47","113","47113","2020"
"Census Tract 16.03, Madison County, Tennessee","340","402","271","90","1107","1103","4","886","217","1107","56738","47","113","47113","2020"
"Census Tract 16.04, Madison County, Tennessee","288","544","213","38","1171","1083","88","869","214","1171","59968","47","113","47113","2020"
"Census Tract 16.05, Madison County, Tennessee","179","505","227","34","1058","945","113","353","592","1058","44432","47","113","47113","2020"
"Census Tract 16.07, Madison County, Tennessee","496","654","604","147","2113","1901","212","1423","478","2113","56050","47","113","47113","2020"
"Census Tract 16.08, Madison County, Tennessee","247","311","301","59","984","918","66","834","84","984","78061","47","113","47113","2020"
"Census Tract 16.09, Madison County, Tennessee","194","191","201","26","658","612","46","469","143","658","73214","47","113","47113","2020"
"Census Tract 16.10, Madison County, Tennessee","421","910","962","75","2443","2368","75","2252","116","2443","109438","47","113","47113","2020"
"Census Tract 16.11, Madison County, Tennessee","132","383","424","0","965","939","26","791","148","965","65436","47","113","47113","2020"
"Census Tract 607, Washington County, Tennessee","0","0","0","0","0","0","0","0","0","0","-666666666","47","179","47179","2020"
"Census Tract 608, Washington County, Tennessee","356","623","314","18","1663","1311","352","421","890","1663","36738","47","179","47179","2020"
"Census Tract 609.01, Washington County, Tennessee","407","480","342","0","1395","1229","166","314","915","1395","24977","47","179","47179","2020"
"Census Tract 609.02, Washington County, Tennessee","549","547","261","11","1621","1368","253","464","904","1621","28058","47","179","47179","2020"
"Census Tract 610, Washington County, Tennessee","345","476","231","37","1230","1089","141","475","614","1230","32292","47","179","47179","2020"
"Census Tract 611, Washington County, Tennessee","669","750","481","133","2236","2033","203","1349","684","2236","51483","47","179","47179","2020"
"Census Tract 612, Washington County, Tennessee","437","671","348","82","1789","1538","251","892","646","1789","33226","47","179","47179","2020"
"Census Tract 613.01, Washington County, Tennessee","324","472","260","182","1415","1238","177","592","646","1415","41356","47","179","47179","2020"
"Census Tract 613.02, Washington County, Tennessee","399","1155","542","45","2197","2141","56","1528","613","2197","67768","47","179","47179","2020"
"Census Tract 614.01, Washington County, Tennessee","734","684","471","79","2242","1968","274","1738","230","2242","68312","47","179","47179","2020"
"Census Tract 614.03, Washington County, Tennessee","447","894","823","28","2306","2192","114","1115","1077","2306","54773","47","179","47179","2020"
"Census Tract 614.04, Washington County, Tennessee","360","573","458","122","1584","1513","71","1039","474","1584","67432","47","179","47179","2020"
"Census Tract 615, Washington County, Tennessee","1365","1174","573","155","3714","3267","447","2313","954","3714","52726","47","179","47179","2020"
"Census Tract 616.01, Washington County, Tennessee","467","624","814","42","2085","1947","138","1797","150","2085","85092","47","179","47179","2020"
"Census Tract 616.03, Washington County, Tennessee","459","769","814","87","2450","2129","321","1726","403","2450","68299","47","179","47179","2020"
"Census Tract 616.04, Washington County, Tennessee","623","369","443","149","1876","1584","292","1515","69","1876","71395","47","179","47179","2020"
"Census Tract 617.01, Washington County, Tennessee","532","867","919","87","2481","2405","76","1756","649","2481","84698","47","179","47179","2020"
"Census Tract 617.03, Washington County, Tennessee","719","298","408","25","1555","1450","105","1217","233","1555","57098","47","179","47179","2020"
"Census Tract 617.04, Washington County, Tennessee","641","610","567","93","2098","1911","187","1349","562","2098","57907","47","179","47179","2020"
"Census Tract 618, Washington County, Tennessee","1034","749","844","86","3066","2713","353","2461","252","3066","51980","47","179","47179","2020"
"Census Tract 619.02, Washington County, Tennessee","591","817","541","126","2326","2075","251","1605","470","2326","57830","47","179","47179","2020"
"Census Tract 619.03, Washington County, Tennessee","504","643","439","98","1684","1684","0","1447","237","1684","42040","47","179","47179","2020"
"Census Tract 619.04, Washington County, Tennessee","620","384","377","81","1554","1462","92","1171","291","1554","38860","47","179","47179","2020"
"Census Tract 620, Washington County, Tennessee","976","760","277","79","2266","2092","174","498","1594","2266","27072","47","179","47179","2020"
"Census Tract 9501, Wayne County, Tennessee","306","427","384","19","1408","1136","272","952","184","1408","42733","47","181","47181","2020"
"Census Tract 9502, Wayne County, Tennessee","855","498","618","47","2583","2018","565","1383","635","2583","51034","47","181","47181","2020"
"Census Tract 9503, Wayne County, Tennessee","640","490","281","44","1833","1455","378","1114","341","1833","40548","47","181","47181","2020"
"Census Tract 9504, Wayne County, Tennessee","474","370","253","31","1529","1128","401","1058","70","1529","41111","47","181","47181","2020"
"Census Tract 9680, Weakley County, Tennessee","209","147","139","14","623","509","114","478","31","623","49583","47","183","47183","2020"
"Census Tract 9681.01, Weakley County, Tennessee","655","362","367","83","1686","1467","219","847","620","1686","40689","47","183","47183","2020"
"Census Tract 9681.02, Weakley County, Tennessee","283","264","258","16","973","821","152","661","160","973","56985","47","183","47183","2020"
"Census Tract 9682.01, Weakley County, Tennessee","690","700","415","103","2089","1908","181","1308","600","2089","43472","47","183","47183","2020"
"Census Tract 9682.02, Weakley County, Tennessee","114","87","18","0","390","219","171","0","219","390","10959","47","183","47183","2020"
"Census Tract 9682.03, Weakley County, Tennessee","368","572","351","113","1623","1404","219","295","1109","1623","30761","47","183","47183","2020"
"Census Tract 9683, Weakley County, Tennessee","413","336","276","51","1275","1076","199","695","381","1275","41633","47","183","47183","2020"
"Census Tract 9684, Weakley County, Tennessee","549","782","481","110","2036","1922","114","1227","695","2036","45746","47","183","47183","2020"
"Census Tract 9685, Weakley County, Tennessee","533","769","519","85","2216","1906","310","1427","479","2216","42432","47","183","47183","2020"
"Census Tract 9686, Weakley County, Tennessee","623","629","272","113","1912","1637","275","1205","432","1912","36894","47","183","47183","2020"
"Census Tract 9687, Weakley County, Tennessee","282","271","125","16","790","694","96","622","72","790","48333","47","183","47183","2020"
"Census Tract 9350, White County, Tennessee","561","683","395","22","1933","1661","272","1512","149","1933","38339","47","185","47185","2020"
"Census Tract 9351, White County, Tennessee","729","612","968","29","2763","2338","425","1762","576","2763","49719","47","185","47185","2020"
"Census Tract 9352, White County, Tennessee","629","509","311","92","1770","1541","229","1271","270","1770","40363","47","185","47185","2020"
"Census Tract 9353, White County, Tennessee","521","895","382","155","2352","1953","399","1354","599","2352","47784","47","185","47185","2020"
"Census Tract 9354, White County, Tennessee","599","499","240","8","1519","1346","173","889","457","1519","31239","47","185","47185","2020"
"Census Tract 9355, White County, Tennessee","490","420","422","48","1667","1380","287","1130","250","1667","47711","47","185","47185","2020"
"Census Tract 9705.01, Coffee County, Tennessee","119","246","35","0","491","400","91","317","83","491","44271","47","031","47031","2020"
"Census Tract 9705.02, Coffee County, Tennessee","387","1094","443","61","2088","1985","103","1109","876","2088","61097","47","031","47031","2020"
"Census Tract 9706, Coffee County, Tennessee","401","716","364","68","1692","1549","143","755","794","1692","48156","47","031","47031","2020"
"Census Tract 9707, Coffee County, Tennessee","654","481","599","132","2032","1866","166","1522","344","2032","53077","47","031","47031","2020"
"Census Tract 9708.01, Coffee County, Tennessee","588","739","352","67","1934","1746","188","858","888","1934","43636","47","031","47031","2020"
"Census Tract 9708.03, Coffee County, Tennessee","316","261","396","89","1213","1062","151","904","158","1213","66907","47","031","47031","2020"
"Census Tract 9708.04, Coffee County, Tennessee","492","349","521","47","1409","1409","0","1298","111","1409","81806","47","031","47031","2020"
"Census Tract 9709, Coffee County, Tennessee","657","735","266","98","1945","1756","189","701","1055","1945","30437","47","031","47031","2020"
"Census Tract 9710.01, Coffee County, Tennessee","144","163","133","0","494","440","54","134","306","494","60605","47","031","47031","2020"
"Census Tract 9710.02, Coffee County, Tennessee","746","856","479","79","2282","2160","122","1463","697","2282","46816","47","031","47031","2020"
"Census Tract 9801, Coffee County, Tennessee","0","4","0","0","4","4","0","4","0","4","-666666666","47","031","47031","2020"
"Census Tract 9610, Crockett County, Tennessee","334","224","250","33","951","841","110","695","146","951","51713","47","033","47033","2020"
"Census Tract 9611, Crockett County, Tennessee","493","617","429","64","1796","1603","193","1138","465","1796","44375","47","033","47033","2020"
"Census Tract 9612, Crockett County, Tennessee","208","300","155","22","809","685","124","529","156","809","49219","47","033","47033","2020"
"Census Tract 9613, Crockett County, Tennessee","346","354","256","48","1154","1004","150","753","251","1154","48621","47","033","47033","2020"
"Census Tract 9614, Crockett County, Tennessee","411","584","424","101","1717","1520","197","850","670","1717","43214","47","033","47033","2020"
"Census Tract 9701.01, Cumberland County, Tennessee","1814","460","132","0","2584","2406","178","2023","383","2584","61926","47","035","47035","2020"
"Census Tract 9701.03, Cumberland County, Tennessee","1049","349","87","118","1954","1603","351","1334","269","1954","46750","47","035","47035","2020"
"Census Tract 9701.04, Cumberland County, Tennessee","1022","233","155","10","1734","1420","314","1313","107","1734","55286","47","035","47035","2020"
"Census Tract 9702.01, Cumberland County, Tennessee","624","438","548","265","1968","1875","93","1648","227","1968","51823","47","035","47035","2020"
"Census Tract 9702.02, Cumberland County, Tennessee","245","293","247","29","814","814","0","727","87","814","59861","47","035","47035","2020"
"Census Tract 9703.01, Cumberland County, Tennessee","629","365","360","37","1668","1391","277","1155","236","1668","52135","47","035","47035","2020"
"Census Tract 9703.02, Cumberland County, Tennessee","856","492","249","88","2060","1685","375","1426","259","2060","41607","47","035","47035","2020"
"Census Tract 9704.01, Cumberland County, Tennessee","1000","471","339","224","2288","2034","254","718","1316","2288","33053","47","035","47035","2020"
"Census Tract 9704.02, Cumberland County, Tennessee","284","385","89","48","824","806","18","600","206","824","44500","47","035","47035","2020"
"Census Tract 9705.01, Cumberland County, Tennessee","498","339","345","65","1406","1247","159","937","310","1406","47052","47","035","47035","2020"
"Census Tract 9705.02, Cumberland County, Tennessee","438","609","472","16","1791","1535","256","690","845","1791","34075","47","035","47035","2020"
"Census Tract 9706.01, Cumberland County, Tennessee","768","733","602","88","2324","2191","133","1690","501","2324","64583","47","035","47035","2020"
"Census Tract 9706.02, Cumberland County, Tennessee","724","502","395","78","1934","1699","235","1558","141","1934","54069","47","035","47035","2020"
"Census Tract 9706.03, Cumberland County, Tennessee","266","473","111","56","1013","906","107","764","142","1013","51250","47","035","47035","2020"
"Census Tract 9707.01, Cumberland County, Tennessee","576","208","197","48","1258","1029","229","944","85","1258","51596","47","035","47035","2020"
"Census Tract 9707.02, Cumberland County, Tennessee","751","802","356","77","2262","1986","276","1801","185","2262","43306","47","035","47035","2020"
"Census Tract 9708, Cumberland County, Tennessee","724","735","275","28","2199","1762","437","1541","221","2199","50698","47","035","47035","2020"
"Census Tract 101.03, Davidson County, Tennessee","328","356","242","98","1069","1024","45","869","155","1069","60000","47","037","47037","2020"
"Census Tract 101.04, Davidson County, Tennessee","546","489","258","104","1538","1397","141","1175","222","1538","84831","47","037","47037","2020"
"Census Tract 101.05, Davidson County, Tennessee","583","719","630","101","2150","2033","117","1636","397","2150","61115","47","037","47037","2020"
"Census Tract 101.06, Davidson County, Tennessee","169","408","443","67","1194","1087","107","869","218","1194","66940","47","037","47037","2020"
"Census Tract 102.01, Davidson County, Tennessee","376","789","508","96","1811","1769","42","1397","372","1811","69185","47","037","47037","2020"
"Census Tract 102.02, Davidson County, Tennessee","391","582","418","149","1710","1540","170","1272","268","1710","81695","47","037","47037","2020"
"Census Tract 103.01, Davidson County, Tennessee","416","672","385","115","1597","1588","9","970","618","1597","52806","47","037","47037","2020"
"Census Tract 103.02, Davidson County, Tennessee","198","329","172","24","774","723","51","415","308","774","50341","47","037","47037","2020"
"Census Tract 103.03, Davidson County, Tennessee","694","1264","620","88","2772","2666","106","1120","1546","2772","46604","47","037","47037","2020"
"Census Tract 104.01, Davidson County, Tennessee","346","1206","509","113","2509","2174","335","759","1415","2509","47025","47","037","47037","2020"
"Census Tract 104.03, Davidson County, Tennessee","559","674","482","48","1908","1763","145","302","1461","1908","26856","47","037","47037","2020"
"Census Tract 104.04, Davidson County, Tennessee","206","263","281","57","853","807","46","321","486","853","52306","47","037","47037","2020"
"Census Tract 16.12, Madison County, Tennessee","763","1256","642","108","3249","2769","480","1158","1611","3249","49767","47","113","47113","2020"
"Census Tract 17, Madison County, Tennessee","225","136","219","62","721","642","79","467","175","721","60444","47","113","47113","2020"
"Census Tract 18, Madison County, Tennessee","425","536","294","73","1456","1328","128","1046","282","1456","50152","47","113","47113","2020"
"Census Tract 19, Madison County, Tennessee","614","426","408","84","1739","1532","207","1417","115","1739","55750","47","113","47113","2020"
"Census Tract 501.01, Marion County, Tennessee","401","750","382","54","1977","1587","390","1299","288","1977","55521","47","115","47115","2020"
"Census Tract 501.02, Marion County, Tennessee","708","796","517","312","2758","2333","425","1698","635","2758","55602","47","115","47115","2020"
"Census Tract 502.01, Marion County, Tennessee","678","800","319","92","2114","1889","225","1544","345","2114","50232","47","115","47115","2020"
"Census Tract 502.03, Marion County, Tennessee","195","265","380","30","1007","870","137","678","192","1007","58750","47","115","47115","2020"
"Census Tract 502.04, Marion County, Tennessee","476","489","183","94","1404","1242","162","993","249","1404","35326","47","115","47115","2020"
"Census Tract 503.01, Marion County, Tennessee","895","844","433","72","2626","2244","382","1445","799","2626","44011","47","115","47115","2020"
"Census Tract 503.02, Marion County, Tennessee","646","330","266","31","1619","1273","346","947","326","1619","52572","47","115","47115","2020"
"Census Tract 9550, Marshall County, Tennessee","619","1194","1045","128","3191","2986","205","2498","488","3191","68784","47","117","47117","2020"
"Census Tract 9551, Marshall County, Tennessee","691","811","615","174","2589","2291","298","1918","373","2589","54289","47","117","47117","2020"
"Census Tract 9552, Marshall County, Tennessee","805","780","687","119","2559","2391","168","1630","761","2559","48202","47","117","47117","2020"
"Census Tract 9553, Marshall County, Tennessee","471","562","305","83","1716","1421","295","512","909","1716","34867","47","117","47117","2020"
"Census Tract 9554, Marshall County, Tennessee","438","667","387","69","1710","1561","149","1067","494","1710","51522","47","117","47117","2020"
"Census Tract 9555, Marshall County, Tennessee","548","507","546","185","2010","1786","224","1460","326","2010","60814","47","117","47117","2020"
"Census Tract 101, Maury County, Tennessee","506","366","478","39","1632","1389","243","1217","172","1632","55443","47","119","47119","2020"
"Census Tract 102.01, Maury County, Tennessee","497","837","1079","125","2651","2538","113","2116","422","2651","82705","47","119","47119","2020"
"Census Tract 102.03, Maury County, Tennessee","438","407","420","81","1346","1346","0","1244","102","1346","89405","47","119","47119","2020"
"Census Tract 102.04, Maury County, Tennessee","293","1367","1059","198","2988","2917","71","1269","1648","2988","80409","47","119","47119","2020"
"Census Tract 102.05, Maury County, Tennessee","220","129","105","52","612","506","106","477","29","612","45645","47","119","47119","2020"
"Census Tract 103.01, Maury County, Tennessee","547","799","1093","205","2787","2644","143","2478","166","2787","75709","47","119","47119","2020"
"Census Tract 103.02, Maury County, Tennessee","278","371","389","80","1290","1118","172","999","119","1290","68672","47","119","47119","2020"
"Census Tract 104.01, Maury County, Tennessee","295","815","478","86","1937","1674","263","980","694","1937","53826","47","119","47119","2020"
"Census Tract 104.02, Maury County, Tennessee","224","569","192","52","1072","1037","35","429","608","1072","50167","47","119","47119","2020"
"Census Tract 105, Maury County, Tennessee","546","808","191","175","2210","1720","490","791","929","2210","34444","47","119","47119","2020"
"Census Tract 106, Maury County, Tennessee","377","1107","371","121","2162","1976","186","1117","859","2162","40583","47","119","47119","2020"
"Census Tract 107, Maury County, Tennessee","616","1127","421","13","2503","2177","326","1099","1078","2503","37337","47","119","47119","2020"
"Census Tract 108.01, Maury County, Tennessee","285","364","622","81","1444","1352","92","1165","187","1444","72321","47","119","47119","2020"
"Census Tract 108.02, Maury County, Tennessee","632","1082","832","216","2941","2762","179","1866","896","2941","52000","47","119","47119","2020"
"Census Tract 109, Maury County, Tennessee","361","429","353","126","1397","1269","128","1087","182","1397","53696","47","119","47119","2020"
"Census Tract 110.01, Maury County, Tennessee","212","479","296","124","1225","1111","114","1037","74","1225","47250","47","119","47119","2020"
"Census Tract 110.03, Maury County, Tennessee","242","286","125","146","992","799","193","657","142","992","64604","47","119","47119","2020"
"Census Tract 110.04, Maury County, Tennessee","651","517","438","0","1666","1606","60","867","739","1666","40563","47","119","47119","2020"
"Census Tract 111.01, Maury County, Tennessee","449","704","398","250","1990","1801","189","1491","310","1990","77886","47","119","47119","2020"
"Census Tract 111.02, Maury County, Tennessee","366","420","358","139","1353","1283","70","930","353","1353","70361","47","119","47119","2020"
"Census Tract 112, Maury County, Tennessee","525","828","669","116","2276","2138","138","1929","209","2276","54893","47","119","47119","2020"
"Census Tract 9601, Meigs County, Tennessee","690","294","285","103","1754","1372","382","1126","246","1754","50500","47","121","47121","2020"
"Census Tract 9602, Meigs County, Tennessee","838","425","534","109","2074","1906","168","1344","562","2074","43889","47","121","47121","2020"
"Census Tract 9603, Meigs County, Tennessee","705","544","462","90","2095","1801","294","1586","215","2095","55698","47","121","47121","2020"
"Census Tract 9250.01, Monroe County, Tennessee","871","769","233","100","2254","1973","281","1770","203","2254","70961","47","123","47123","2020"
"Census Tract 9250.02, Monroe County, Tennessee","538","593","414","50","1786","1595","191","955","640","1786","47676","47","123","47123","2020"
"Census Tract 9251.01, Monroe County, Tennessee","666","948","286","95","2049","1995","54","1338","657","2049","36743","47","123","47123","2020"
"Census Tract 9251.02, Monroe County, Tennessee","356","617","341","63","1550","1377","173","985","392","1550","51302","47","123","47123","2020"
"Census Tract 9252, Monroe County, Tennessee","850","684","360","82","2244","1976","268","1131","845","2244","34840","47","123","47123","2020"
"Census Tract 501.02, Williamson County, Tennessee","232","347","702","333","1642","1614","28","1579","35","1642","145703","47","187","47187","2020"
"Census Tract 501.03, Williamson County, Tennessee","703","853","767","146","2501","2469","32","2374","95","2501","117946","47","187","47187","2020"
"Census Tract 501.04, Williamson County, Tennessee","205","676","282","182","1380","1345","35","1142","203","1380","152846","47","187","47187","2020"
"Census Tract 501.05, Williamson County, Tennessee","138","645","947","196","1982","1926","56","1778","148","1982","180206","47","187","47187","2020"
"Census Tract 502.04, Williamson County, Tennessee","347","584","837","107","1904","1875","29","1794","81","1904","143995","47","187","47187","2020"
"Census Tract 502.05, Williamson County, Tennessee","310","307","526","68","1211","1211","0","1177","34","1211","130781","47","187","47187","2020"
"Census Tract 502.06, Williamson County, Tennessee","169","347","372","65","1000","953","47","887","66","1000","175313","47","187","47187","2020"
"Census Tract 502.07, Williamson County, Tennessee","83","629","407","112","1259","1231","28","1212","19","1259","214821","47","187","47187","2020"
"Census Tract 502.09, Williamson County, Tennessee","295","510","413","21","1239","1239","0","1134","105","1239","180231","47","187","47187","2020"
"Census Tract 502.10, Williamson County, Tennessee","170","192","356","31","794","749","45","670","79","794","205859","47","187","47187","2020"
"Census Tract 502.11, Williamson County, Tennessee","334","1736","905","107","3387","3082","305","683","2399","3387","91628","47","187","47187","2020"
"Census Tract 502.12, Williamson County, Tennessee","70","247","351","18","686","686","0","590","96","686","250001","47","187","47187","2020"
"Census Tract 503.03, Williamson County, Tennessee","222","399","316","134","1103","1071","32","1044","27","1103","176417","47","187","47187","2020"
"Census Tract 503.04, Williamson County, Tennessee","224","472","354","10","1249","1060","189","541","519","1249","123026","47","187","47187","2020"
"Census Tract 503.05, Williamson County, Tennessee","178","405","295","119","1021","997","24","901","96","1021","249583","47","187","47187","2020"
"Census Tract 503.06, Williamson County, Tennessee","138","229","222","96","726","685","41","609","76","726","112679","47","187","47187","2020"
"Census Tract 503.07, Williamson County, Tennessee","515","999","568","85","2324","2167","157","979","1188","2324","66788","47","187","47187","2020"
"Census Tract 504.03, Williamson County, Tennessee","113","419","177","66","824","775","49","754","21","824","128750","47","187","47187","2020"
"Census Tract 504.04, Williamson County, Tennessee","495","799","1053","106","2453","2453","0","2453","0","2453","175515","47","187","47187","2020"
"Census Tract 504.05, Williamson County, Tennessee","183","287","413","29","958","912","46","863","49","958","191250","47","187","47187","2020"
"Census Tract 504.06, Williamson County, Tennessee","373","743","766","126","2059","2008","51","1645","363","2059","139583","47","187","47187","2020"
"Census Tract 505.02, Williamson County, Tennessee","397","541","385","98","1544","1421","123","1095","326","1544","78601","47","187","47187","2020"
"Census Tract 505.03, Williamson County, Tennessee","596","630","872","111","2353","2209","144","1675","534","2353","72587","47","187","47187","2020"
"Census Tract 505.04, Williamson County, Tennessee","161","588","593","134","1527","1476","51","1217","259","1527","66858","47","187","47187","2020"
"Census Tract 506.01, Williamson County, Tennessee","469","833","894","117","2420","2313","107","1700","613","2420","76875","47","187","47187","2020"
"Census Tract 506.03, Williamson County, Tennessee","381","549","291","79","1412","1300","112","1069","231","1412","90781","47","187","47187","2020"
"Census Tract 506.04, Williamson County, Tennessee","603","1621","903","134","3463","3261","202","2419","842","3463","125575","47","187","47187","2020"
"Census Tract 507.01, Williamson County, Tennessee","201","708","545","33","1515","1487","28","1198","289","1515","88552","47","187","47187","2020"
"Census Tract 507.02, Williamson County, Tennessee","369","429","570","171","1546","1539","7","1428","111","1546","135841","47","187","47187","2020"
"Census Tract 508.01, Williamson County, Tennessee","445","870","470","55","2006","1840","166","1086","754","2006","38646","47","187","47187","2020"
"Census Tract 508.02, Williamson County, Tennessee","80","233","279","0","611","592","19","371","221","611","107763","47","187","47187","2020"
"Census Tract 509.04, Williamson County, Tennessee","186","793","590","284","1948","1853","95","983","870","1948","85094","47","187","47187","2020"
"Census Tract 509.05, Williamson County, Tennessee","424","1101","1114","188","2945","2827","118","1264","1563","2945","102240","47","187","47187","2020"
"Census Tract 509.06, Williamson County, Tennessee","343","848","726","167","2159","2084","75","1884","200","2159","113000","47","187","47187","2020"
"Census Tract 509.07, Williamson County, Tennessee","457","652","829","66","2052","2004","48","1440","564","2052","102083","47","187","47187","2020"
"Census Tract 509.08, Williamson County, Tennessee","359","468","413","124","1429","1364","65","1327","37","1429","133750","47","187","47187","2020"
"Census Tract 509.09, Williamson County, Tennessee","149","509","592","141","1455","1391","64","1329","62","1455","148875","47","187","47187","2020"
"Census Tract 510.01, Williamson County, Tennessee","324","862","1204","173","2599","2563","36","2443","120","2599","155768","47","187","47187","2020"
"Census Tract 510.02, Williamson County, Tennessee","356","1230","1454","258","3406","3298","108","2515","783","3406","134200","47","187","47187","2020"
"Census Tract 511, Williamson County, Tennessee","514","1088","1243","239","3135","3084","51","2550","534","3135","113882","47","187","47187","2020"
"Census Tract 512.03, Williamson County, Tennessee","254","502","231","89","1288","1076","212","1028","48","1288","57833","47","187","47187","2020"
"Census Tract 512.04, Williamson County, Tennessee","233","730","920","66","2049","1949","100","1555","394","2049","122679","47","187","47187","2020"
"Census Tract 512.05, Williamson County, Tennessee","199","638","1163","118","2314","2118","196","1859","259","2314","102960","47","187","47187","2020"
"Census Tract 512.06, Williamson County, Tennessee","736","635","1226","149","2845","2746","99","2356","390","2845","68893","47","187","47187","2020"
"Census Tract 105.01, Davidson County, Tennessee","634","806","796","236","2700","2472","228","1648","824","2700","62196","47","037","47037","2020"
"Census Tract 105.02, Davidson County, Tennessee","448","874","694","86","2155","2102","53","1655","447","2155","68679","47","037","47037","2020"
"Census Tract 106.01, Davidson County, Tennessee","531","761","667","229","2291","2188","103","1455","733","2291","64698","47","037","47037","2020"
"Census Tract 106.02, Davidson County, Tennessee","215","548","450","134","1349","1347","2","866","481","1349","49173","47","037","47037","2020"
"Census Tract 107.01, Davidson County, Tennessee","308","942","544","65","2107","1859","248","614","1245","2107","44963","47","037","47037","2020"
"Census Tract 107.02, Davidson County, Tennessee","614","690","266","57","1896","1627","269","273","1354","1896","31225","47","037","47037","2020"
"Census Tract 108.01, Davidson County, Tennessee","595","1150","663","173","2660","2581","79","1484","1097","2660","54215","47","037","47037","2020"
"Census Tract 108.02, Davidson County, Tennessee","727","658","288","127","2022","1800","222","989","811","2022","42138","47","037","47037","2020"
"Census Tract 109.01, Davidson County, Tennessee","231","432","342","163","1338","1168","170","758","410","1338","64625","47","037","47037","2020"
"Census Tract 109.03, Davidson County, Tennessee","469","1095","491","201","2370","2256","114","1220","1036","2370","43354","47","037","47037","2020"
"Census Tract 109.04, Davidson County, Tennessee","405","836","173","40","1504","1454","50","627","827","1504","32800","47","037","47037","2020"
"Census Tract 110.01, Davidson County, Tennessee","462","918","981","148","2677","2509","168","1266","1243","2677","50884","47","037","47037","2020"
"Census Tract 110.02, Davidson County, Tennessee","116","405","452","57","1177","1030","147","575","455","1177","57273","47","037","47037","2020"
"Census Tract 111, Davidson County, Tennessee","298","686","533","135","1761","1652","109","1177","475","1761","79878","47","037","47037","2020"
"Census Tract 112, Davidson County, Tennessee","636","680","711","134","2421","2161","260","1555","606","2421","52865","47","037","47037","2020"
"Census Tract 113, Davidson County, Tennessee","354","955","785","103","2532","2197","335","1289","908","2532","59107","47","037","47037","2020"
"Census Tract 114, Davidson County, Tennessee","607","774","543","239","2563","2163","400","1273","890","2563","54586","47","037","47037","2020"
"Census Tract 115, Davidson County, Tennessee","318","920","496","47","1845","1781","64","1434","347","1845","60438","47","037","47037","2020"
"Census Tract 116, Davidson County, Tennessee","306","833","1061","82","2367","2282","85","1647","635","2367","78520","47","037","47037","2020"
"Census Tract 117, Davidson County, Tennessee","180","1086","899","241","2675","2406","269","1336","1070","2675","76667","47","037","47037","2020"
"Census Tract 118, Davidson County, Tennessee","181","427","541","27","1337","1176","161","541","635","1337","59700","47","037","47037","2020"
"Census Tract 119, Davidson County, Tennessee","170","611","361","21","1507","1163","344","271","892","1507","51875","47","037","47037","2020"
"Census Tract 121, Davidson County, Tennessee","46","582","383","66","1221","1077","144","786","291","1221","107868","47","037","47037","2020"
"Census Tract 122, Davidson County, Tennessee","157","394","421","39","1224","1011","213","675","336","1224","93701","47","037","47037","2020"
"Census Tract 126, Davidson County, Tennessee","87","301","244","122","891","754","137","362","392","891","56667","47","037","47037","2020"
"Census Tract 127.01, Davidson County, Tennessee","986","921","453","39","2517","2399","118","1504","895","2517","39033","47","037","47037","2020"
"Census Tract 127.02, Davidson County, Tennessee","360","297","266","52","1223","975","248","601","374","1223","57690","47","037","47037","2020"
"Census Tract 128.01, Davidson County, Tennessee","976","688","380","177","2429","2221","208","1169","1052","2429","32138","47","037","47037","2020"
"Census Tract 128.02, Davidson County, Tennessee","388","402","318","103","1273","1211","62","800","411","1273","49432","47","037","47037","2020"
"Census Tract 130.01, Davidson County, Tennessee","0","15","10","0","53","25","28","10","15","53","-666666666","47","037","47037","2020"
"Census Tract 130.02, Davidson County, Tennessee","0","0","0","0","0","0","0","0","0","0","-666666666","47","037","47037","2020"
"Census Tract 131, Davidson County, Tennessee","247","229","372","93","1060","941","119","748","193","1060","74250","47","037","47037","2020"
"Census Tract 132.01, Davidson County, Tennessee","276","599","299","104","1392","1278","114","808","470","1392","52697","47","037","47037","2020"
"Census Tract 132.02, Davidson County, Tennessee","237","561","566","61","1557","1425","132","950","475","1557","64986","47","037","47037","2020"
"Census Tract 133, Davidson County, Tennessee","345","706","854","31","2052","1936","116","1197","739","2052","77955","47","037","47037","2020"
"Census Tract 134, Davidson County, Tennessee","345","793","831","148","2239","2117","122","1244","873","2239","90978","47","037","47037","2020"
"Census Tract 135, Davidson County, Tennessee","139","604","390","83","1277","1216","61","516","700","1277","73750","47","037","47037","2020"
"Census Tract 136, Davidson County, Tennessee","744","761","200","67","1877","1772","105","321","1451","1877","28779","47","037","47037","2020"
"Census Tract 137.01, Davidson County, Tennessee","756","572","360","94","1900","1782","118","633","1149","1900","41693","47","037","47037","2020"
"Census Tract 137.02, Davidson County, Tennessee","519","475","390","28","1495","1412","83","102","1310","1495","33542","47","037","47037","2020"
"Census Tract 138, Davidson County, Tennessee","182","309","167","104","808","762","46","286","476","808","40571","47","037","47037","2020"
"Census Tract 139, Davidson County, Tennessee","211","289","157","17","823","674","149","227","447","823","34741","47","037","47037","2020"
"Census Tract 142, Davidson County, Tennessee","359","224","100","17","871","700","171","100","600","871","24237","47","037","47037","2020"
"Census Tract 143, Davidson County, Tennessee","143","379","129","35","905","686","219","143","543","905","40425","47","037","47037","2020"
"Census Tract 144, Davidson County, Tennessee","318","843","237","0","1526","1398","128","21","1377","1526","45960","47","037","47037","2020"
"Census Tract 9253.01, Monroe County, Tennessee","718","406","291","136","1639","1551","88","1145","406","1639","37917","47","123","47123","2020"
"Census Tract 9253.02, Monroe County, Tennessee","609","374","455","0","1571","1438","133","1040","398","1571","36222","47","123","47123","2020"
"Census Tract 9254.01, Monroe County, Tennessee","712","502","449","45","1922","1708","214","1390","318","1922","47226","47","123","47123","2020"
"Census Tract 9254.02, Monroe County, Tennessee","867","383","396","134","1943","1780","163","1196","584","1943","32993","47","123","47123","2020"
"Census Tract 9255.01, Monroe County, Tennessee","574","313","321","20","1591","1228","363","940","288","1591","40000","47","123","47123","2020"
"Census Tract 9255.03, Monroe County, Tennessee","338","640","191","62","1549","1231","318","1182","49","1549","50952","47","123","47123","2020"
"Census Tract 9255.04, Monroe County, Tennessee","343","235","182","27","1228","787","441","728","59","1228","50256","47","123","47123","2020"
"Census Tract 1001, Montgomery County, Tennessee","213","199","117","6","677","535","142","15","520","677","15040","47","125","47125","2020"
"Census Tract 1002, Montgomery County, Tennessee","259","277","205","13","960","754","206","300","454","960","31778","47","125","47125","2020"
"Census Tract 1003, Montgomery County, Tennessee","687","892","549","66","2319","2194","125","1201","993","2319","42342","47","125","47125","2020"
"Census Tract 1005, Montgomery County, Tennessee","686","1122","445","40","2546","2293","253","784","1509","2546","36255","47","125","47125","2020"
"Census Tract 1006.01, Montgomery County, Tennessee","273","293","169","32","852","767","85","515","252","852","63625","47","125","47125","2020"
"Census Tract 1006.02, Montgomery County, Tennessee","503","495","255","88","1537","1341","196","630","711","1537","45407","47","125","47125","2020"
"Census Tract 1008, Montgomery County, Tennessee","259","350","91","13","898","713","185","169","544","898","29464","47","125","47125","2020"
"Census Tract 1009, Montgomery County, Tennessee","429","421","365","6","1521","1221","300","163","1058","1521","26597","47","125","47125","2020"
"Census Tract 1010.01, Montgomery County, Tennessee","299","746","424","59","1763","1528","235","868","660","1763","44637","47","125","47125","2020"
"Census Tract 1010.02, Montgomery County, Tennessee","182","751","501","42","1640","1476","164","1101","375","1640","64010","47","125","47125","2020"
"Census Tract 1011.01, Montgomery County, Tennessee","252","638","235","20","1362","1145","217","654","491","1362","53589","47","125","47125","2020"
"Census Tract 1011.02, Montgomery County, Tennessee","598","1226","1096","192","3584","3112","472","2086","1026","3584","52330","47","125","47125","2020"
"Census Tract 1011.03, Montgomery County, Tennessee","165","404","298","17","1013","884","129","684","200","1013","61563","47","125","47125","2020"
"Census Tract 1012.01, Montgomery County, Tennessee","378","486","97","38","1102","999","103","246","753","1102","30734","47","125","47125","2020"
"Census Tract 1012.02, Montgomery County, Tennessee","224","806","564","143","1958","1737","221","952","785","1958","58508","47","125","47125","2020"
"Census Tract 1013.04, Montgomery County, Tennessee","458","1028","510","121","2169","2117","52","841","1276","2169","44572","47","125","47125","2020"
"Census Tract 1013.05, Montgomery County, Tennessee","257","1005","836","125","2424","2223","201","1358","865","2424","70495","47","125","47125","2020"
"Census Tract 1013.06, Montgomery County, Tennessee","190","937","599","99","2072","1825","247","1119","706","2072","48880","47","125","47125","2020"
"Census Tract 1013.07, Montgomery County, Tennessee","189","469","357","175","1290","1190","100","714","476","1290","57875","47","125","47125","2020"
"Census Tract 1013.08, Montgomery County, Tennessee","217","980","523","27","1950","1747","203","509","1238","1950","50725","47","125","47125","2020"
"Census Tract 1013.09, Montgomery County, Tennessee","449","1049","658","86","2462","2242","220","1515","727","2462","67705","47","125","47125","2020"
"Census Tract 1014, Montgomery County, Tennessee","75","1097","477","34","1845","1683","162","0","1683","1845","57151","47","125","47125","2020"
"Census Tract 1015.01, Montgomery County, Tennessee","500","306","527","81","1543","1414","129","1036","378","1543","55726","47","125","47125","2020"
"Census Tract 1015.02, Montgomery County, Tennessee","461","514","358","142","1876","1475","401","1278","197","1876","73902","47","125","47125","2020"
"Census Tract 1016, Montgomery County, Tennessee","547","694","506","245","2146","1992","154","1505","487","2146","72132","47","125","47125","2020"
"Census Tract 1017.01, Montgomery County, Tennessee","261","415","197","152","1315","1025","290","910","115","1315","73882","47","125","47125","2020"
"Census Tract 1017.02, Montgomery County, Tennessee","521","708","388","154","1997","1771","226","1542","229","1997","66096","47","125","47125","2020"
"Census Tract 1018.03, Montgomery County, Tennessee","749","966","727","339","3122","2781","341","2158","623","3122","92135","47","125","47125","2020"
"Census Tract 1018.05, Montgomery County, Tennessee","253","601","506","25","1425","1385","40","1199","186","1425","103568","47","125","47125","2020"
"Census Tract 1018.06, Montgomery County, Tennessee","652","634","953","276","2621","2515","106","2086","429","2621","76209","47","125","47125","2020"
"Census Tract 1018.07, Montgomery County, Tennessee","270","416","308","287","1347","1281","66","1199","82","1347","107786","47","125","47125","2020"
"Census Tract 1018.08, Montgomery County, Tennessee","230","322","544","179","1331","1275","56","925","350","1331","94063","47","125","47125","2020"
"Census Tract 1019.02, Montgomery County, Tennessee","186","305","229","46","868","766","102","670","96","868","103056","47","125","47125","2020"
"Census Tract 1019.04, Montgomery County, Tennessee","195","652","762","115","1901","1724","177","1436","288","1901","111286","47","125","47125","2020"
"Census Tract 1019.05, Montgomery County, Tennessee","271","827","698","121","1917","1917","0","1595","322","1917","81550","47","125","47125","2020"
"Census Tract 1019.06, Montgomery County, Tennessee","250","876","652","247","2200","2025","175","890","1135","2200","61116","47","125","47125","2020"
"Census Tract 1020.01, Montgomery County, Tennessee","553","1008","640","132","2615","2333","282","1456","877","2615","51833","47","125","47125","2020"
"Census Tract 512.07, Williamson County, Tennessee","30","1168","710","140","2169","2048","121","1480","568","2169","83371","47","187","47187","2020"
"Census Tract 512.08, Williamson County, Tennessee","353","455","1583","299","2690","2690","0","2297","393","2690","106068","47","187","47187","2020"
"Census Tract 301.02, Wilson County, Tennessee","467","973","1124","152","2857","2716","141","2327","389","2857","74107","47","189","47189","2020"
"Census Tract 301.03, Wilson County, Tennessee","252","313","456","176","1197","1197","0","1076","121","1197","87109","47","189","47189","2020"
"Census Tract 301.04, Wilson County, Tennessee","120","279","314","51","973","764","209","730","34","973","100729","47","189","47189","2020"
"Census Tract 301.05, Wilson County, Tennessee","365","421","478","69","1391","1333","58","1177","156","1391","77944","47","189","47189","2020"
"Census Tract 302.02, Wilson County, Tennessee","1067","1082","1003","182","3510","3334","176","2428","906","3510","75538","47","189","47189","2020"
"Census Tract 302.03, Wilson County, Tennessee","363","563","1086","185","2283","2197","86","1763","434","2283","104922","47","189","47189","2020"
"Census Tract 302.05, Wilson County, Tennessee","197","376","142","68","837","783","54","741","42","837","82228","47","189","47189","2020"
"Census Tract 302.06, Wilson County, Tennessee","307","556","716","75","1672","1654","18","1569","85","1672","102244","47","189","47189","2020"
"Census Tract 302.07, Wilson County, Tennessee","184","274","359","37","1001","854","147","735","119","1001","93750","47","189","47189","2020"
"Census Tract 303.03, Wilson County, Tennessee","334","608","745","160","1924","1847","77","1750","97","1924","99835","47","189","47189","2020"
"Census Tract 303.04, Wilson County, Tennessee","632","737","796","181","2456","2346","110","1934","412","2456","75500","47","189","47189","2020"
"Census Tract 303.05, Wilson County, Tennessee","445","656","886","213","2200","2200","0","1877","323","2200","91902","47","189","47189","2020"
"Census Tract 303.08, Wilson County, Tennessee","162","457","851","182","1681","1652","29","1448","204","1681","102286","47","189","47189","2020"
"Census Tract 303.09, Wilson County, Tennessee","482","929","787","98","2319","2296","23","1864","432","2319","78276","47","189","47189","2020"
"Census Tract 303.10, Wilson County, Tennessee","436","665","1026","211","2367","2338","29","1860","478","2367","111978","47","189","47189","2020"
"Census Tract 303.11, Wilson County, Tennessee","418","197","547","52","1424","1214","210","900","314","1424","83750","47","189","47189","2020"
"Census Tract 304.01, Wilson County, Tennessee","334","254","304","15","946","907","39","444","463","946","45469","47","189","47189","2020"
"Census Tract 304.02, Wilson County, Tennessee","353","532","486","198","1725","1569","156","597","972","1725","45511","47","189","47189","2020"
"Census Tract 305, Wilson County, Tennessee","735","680","817","231","2693","2463","230","1294","1169","2693","45194","47","189","47189","2020"
"Census Tract 306, Wilson County, Tennessee","611","433","374","111","1645","1529","116","846","683","1645","49005","47","189","47189","2020"
"Census Tract 307, Wilson County, Tennessee","397","584","322","64","1535","1367","168","448","919","1535","34789","47","189","47189","2020"
"Census Tract 308, Wilson County, Tennessee","493","830","570","229","2357","2122","235","1467","655","2357","57045","47","189","47189","2020"
"Census Tract 309.04, Wilson County, Tennessee","264","391","691","107","1615","1453","162","1255","198","1615","76505","47","189","47189","2020"
"Census Tract 309.05, Wilson County, Tennessee","340","640","683","303","2086","1966","120","1804","162","2086","95045","47","189","47189","2020"
"Census Tract 309.06, Wilson County, Tennessee","391","586","808","88","1982","1873","109","1657","216","1982","105090","47","189","47189","2020"
"Census Tract 309.07, Wilson County, Tennessee","918","773","364","78","2226","2133","93","1703","430","2226","77596","47","189","47189","2020"
"Census Tract 309.08, Wilson County, Tennessee","288","966","1479","142","3396","2875","521","1469","1406","3396","90813","47","189","47189","2020"
"Census Tract 310, Wilson County, Tennessee","820","736","621","189","2569","2366","203","1919","447","2569","63194","47","189","47189","2020"
"Census Tract 151, Davidson County, Tennessee","408","715","501","77","1873","1701","172","1220","481","1873","62515","47","037","47037","2020"
"Census Tract 152, Davidson County, Tennessee","227","557","291","88","1293","1163","130","688","475","1293","56544","47","037","47037","2020"
"Census Tract 153, Davidson County, Tennessee","548","1000","1102","145","3045","2795","250","2334","461","3045","74872","47","037","47037","2020"
"Census Tract 154.01, Davidson County, Tennessee","629","829","761","181","2452","2400","52","2046","354","2452","69597","47","037","47037","2020"
"Census Tract 154.02, Davidson County, Tennessee","242","590","675","182","1885","1689","196","1138","551","1885","68528","47","037","47037","2020"
"Census Tract 154.04, Davidson County, Tennessee","407","506","345","58","1532","1316","216","657","659","1532","47930","47","037","47037","2020"
"Census Tract 154.05, Davidson County, Tennessee","272","959","514","128","1996","1873","123","1299","574","1996","62014","47","037","47037","2020"
"Census Tract 155.01, Davidson County, Tennessee","230","829","419","19","1624","1497","127","642","855","1624","57813","47","037","47037","2020"
"Census Tract 155.02, Davidson County, Tennessee","680","821","440","56","2041","1997","44","1225","772","2041","46953","47","037","47037","2020"
"Census Tract 156.09, Davidson County, Tennessee","275","1175","662","54","2593","2166","427","882","1284","2593","59877","47","037","47037","2020"
"Census Tract 156.13, Davidson County, Tennessee","162","736","385","97","1558","1380","178","490","890","1558","38214","47","037","47037","2020"
"Census Tract 156.14, Davidson County, Tennessee","247","669","430","179","1641","1525","116","902","623","1641","60670","47","037","47037","2020"
"Census Tract 156.15, Davidson County, Tennessee","340","674","354","164","1614","1532","82","1014","518","1614","46786","47","037","47037","2020"
"Census Tract 156.17, Davidson County, Tennessee","182","497","410","44","1190","1133","57","940","193","1190","82440","47","037","47037","2020"
"Census Tract 156.18, Davidson County, Tennessee","394","1177","966","198","2814","2735","79","2019","716","2814","53833","47","037","47037","2020"
"Census Tract 156.19, Davidson County, Tennessee","292","709","698","197","2087","1896","191","1633","263","2087","74167","47","037","47037","2020"
"Census Tract 156.20, Davidson County, Tennessee","403","1312","821","176","2846","2712","134","1895","817","2846","52315","47","037","47037","2020"
"Census Tract 156.22, Davidson County, Tennessee","124","507","570","270","1592","1471","121","1093","378","1592","87420","47","037","47037","2020"
"Census Tract 156.23, Davidson County, Tennessee","479","1135","698","95","2591","2407","184","1196","1211","2591","46989","47","037","47037","2020"
"Census Tract 156.24, Davidson County, Tennessee","168","1163","855","60","2486","2246","240","951","1295","2486","62577","47","037","47037","2020"
"Census Tract 156.25, Davidson County, Tennessee","395","1396","648","195","2711","2634","77","1593","1041","2711","59484","47","037","47037","2020"
"Census Tract 156.26, Davidson County, Tennessee","537","1000","1232","143","3201","2912","289","707","2205","3201","50283","47","037","47037","2020"
"Census Tract 156.27, Davidson County, Tennessee","209","459","408","95","1225","1171","54","1005","166","1225","60181","47","037","47037","2020"
"Census Tract 156.28, Davidson County, Tennessee","238","723","617","104","1910","1682","228","210","1472","1910","55978","47","037","47037","2020"
"Census Tract 156.29, Davidson County, Tennessee","154","1464","835","164","2933","2617","316","497","2120","2933","52402","47","037","47037","2020"
"Census Tract 156.30, Davidson County, Tennessee","201","1062","735","91","2104","2089","15","1406","683","2104","54524","47","037","47037","2020"
"Census Tract 156.32, Davidson County, Tennessee","692","950","366","78","2254","2086","168","337","1749","2254","45545","47","037","47037","2020"
"Census Tract 156.33, Davidson County, Tennessee","402","555","701","174","1858","1832","26","1720","112","1858","108883","47","037","47037","2020"
"Census Tract 156.34, Davidson County, Tennessee","595","1055","1296","448","3771","3394","377","2546","848","3771","77683","47","037","47037","2020"
"Census Tract 156.35, Davidson County, Tennessee","75","466","424","121","1118","1086","32","949","137","1118","103891","47","037","47037","2020"
"Census Tract 156.36, Davidson County, Tennessee","90","388","552","36","1338","1066","272","727","339","1338","73529","47","037","47037","2020"
"Census Tract 156.37, Davidson County, Tennessee","326","931","360","161","1961","1778","183","612","1166","1961","52821","47","037","47037","2020"
"Census Tract 157, Davidson County, Tennessee","55","211","212","88","611","566","45","404","162","611","69167","47","037","47037","2020"
"Census Tract 158.04, Davidson County, Tennessee","332","1272","385","173","2365","2162","203","572","1590","2365","45556","47","037","47037","2020"
"Census Tract 158.05, Davidson County, Tennessee","240","568","461","109","1510","1378","132","555","823","1510","39477","47","037","47037","2020"
"Census Tract 158.06, Davidson County, Tennessee","310","972","390","214","2246","1886","360","309","1577","2246","37595","47","037","47037","2020"
"Census Tract 148, Davidson County, Tennessee","322","170","0","0","511","492","19","0","492","511","13750","47","037","47037","2020"
"Census Tract 159, Davidson County, Tennessee","681","305","152","56","1376","1194","182","214","980","1376","17308","47","037","47037","2020"
"Census Tract 160, Davidson County, Tennessee","334","730","197","24","1511","1285","226","217","1068","1511","21868","47","037","47037","2020"
"Census Tract 161, Davidson County, Tennessee","227","394","376","141","1257","1138","119","371","767","1257","54489","47","037","47037","2020"
"Census Tract 162, Davidson County, Tennessee","585","646","194","105","1788","1530","258","435","1095","1788","26179","47","037","47037","2020"
"Census Tract 163, Davidson County, Tennessee","354","308","385","78","1555","1125","430","425","700","1555","54886","47","037","47037","2020"
"Census Tract 164, Davidson County, Tennessee","390","593","126","16","1592","1125","467","204","921","1592","51941","47","037","47037","2020"
"Census Tract 165, Davidson County, Tennessee","109","462","110","0","910","681","229","0","681","910","58065","47","037","47037","2020"
"Census Tract 166, Davidson County, Tennessee","533","1107","519","15","2508","2174","334","426","1748","2508","51091","47","037","47037","2020"
"Census Tract 1020.04, Montgomery County, Tennessee","419","1353","760","5","2708","2537","171","1283","1254","2708","71779","47","125","47125","2020"
"Census Tract 1020.05, Montgomery County, Tennessee","588","989","847","73","2833","2497","336","1159","1338","2833","57079","47","125","47125","2020"
"Census Tract 1020.07, Montgomery County, Tennessee","17","290","232","25","647","564","83","389","175","647","77200","47","125","47125","2020"
"Census Tract 1020.08, Montgomery County, Tennessee","308","1319","888","62","2654","2577","77","1751","826","2654","63775","47","125","47125","2020"
"Census Tract 1020.09, Montgomery County, Tennessee","282","875","464","76","1886","1697","189","1288","409","1886","88161","47","125","47125","2020"
"Census Tract 1020.10, Montgomery County, Tennessee","191","739","446","67","1443","1443","0","1087","356","1443","67376","47","125","47125","2020"
"Census Tract 1021, Montgomery County, Tennessee","482","819","387","53","2065","1741","324","798","943","2065","39583","47","125","47125","2020"
"Census Tract 9801, Montgomery County, Tennessee","0","0","0","0","0","0","0","0","0","0","-666666666","47","125","47125","2020"
"Census Tract 9301, Moore County, Tennessee","508","530","518","72","1880","1628","252","1338","290","1880","64726","47","127","47127","2020"
"Census Tract 9302, Moore County, Tennessee","288","387","276","20","1189","971","218","838","133","1189","60580","47","127","47127","2020"
"Census Tract 1101, Morgan County, Tennessee","451","324","211","64","1509","1050","459","903","147","1509","34314","47","129","47129","2020"
"Census Tract 1102, Morgan County, Tennessee","726","491","357","28","1883","1602","281","1435","167","1883","40261","47","129","47129","2020"
"Census Tract 1103, Morgan County, Tennessee","686","389","332","101","1612","1508","104","1064","444","1612","40000","47","129","47129","2020"
"Census Tract 1104, Morgan County, Tennessee","585","518","388","41","1765","1532","233","1114","418","1765","43243","47","129","47129","2020"
"Census Tract 1105, Morgan County, Tennessee","642","408","709","73","2286","1832","454","1685","147","2286","44771","47","129","47129","2020"
"Census Tract 9650, Obion County, Tennessee","791","619","356","61","2161","1827","334","1259","568","2161","48007","47","131","47131","2020"
"Census Tract 9651, Obion County, Tennessee","356","259","238","38","963","891","72","627","264","963","50324","47","131","47131","2020"
"Census Tract 9652, Obion County, Tennessee","244","301","170","48","884","763","121","631","132","884","45293","47","131","47131","2020"
"Census Tract 9653, Obion County, Tennessee","563","513","375","51","1924","1502","422","1230","272","1924","41923","47","131","47131","2020"
"Census Tract 9654, Obion County, Tennessee","698","702","472","65","2088","1937","151","1250","687","2088","43196","47","131","47131","2020"
"Census Tract 9655, Obion County, Tennessee","316","411","193","59","1189","979","210","386","593","1189","30625","47","131","47131","2020"
"Census Tract 9656, Obion County, Tennessee","692","756","304","0","1999","1752","247","753","999","1999","24933","47","131","47131","2020"
"Census Tract 9657, Obion County, Tennessee","603","882","370","40","2134","1895","239","1076","819","2134","38250","47","131","47131","2020"
"Census Tract 9658, Obion County, Tennessee","184","186","178","47","721","595","126","510","85","721","57375","47","131","47131","2020"
"Census Tract 9659, Obion County, Tennessee","210","150","106","26","552","492","60","388","104","552","39071","47","131","47131","2020"
"Census Tract 9501, Overton County, Tennessee","248","133","139","19","793","539","254","464","75","793","36326","47","133","47133","2020"
"Census Tract 9502, Overton County, Tennessee","204","327","105","88","799","724","75","561","163","799","35906","47","133","47133","2020"
"Census Tract 9503.01, Overton County, Tennessee","919","582","526","59","2425","2086","339","1351","735","2425","30748","47","133","47133","2020"
"Census Tract 9503.02, Overton County, Tennessee","618","419","199","73","1457","1309","148","991","318","1457","27382","47","133","47133","2020"
"Census Tract 9504, Overton County, Tennessee","284","215","276","37","977","812","165","718","94","977","49138","47","133","47133","2020"
"Census Tract 9505.01, Overton County, Tennessee","572","553","329","193","1748","1647","101","1366","281","1748","41773","47","133","47133","2020"
"Census Tract 9505.02, Overton County, Tennessee","171","265","240","110","959","786","173","682","104","959","54034","47","133","47133","2020"
"Census Tract 9506, Overton County, Tennessee","469","307","156","134","1227","1066","161","860","206","1227","41071","47","133","47133","2020"
"Census Tract 9301, Perry County, Tennessee","446","375","260","49","2054","1130","924","898","232","2054","45602","47","135","47135","2020"
"Census Tract 9302.01, Perry County, Tennessee","354","282","263","45","1364","944","420","727","217","1364","48750","47","135","47135","2020"
"Census Tract 9302.02, Perry County, Tennessee","415","126","290","24","1263","855","408","700","155","1263","53953","47","135","47135","2020"
"Census Tract 9251.01, Pickett County, Tennessee","631","395","235","19","2387","1280","1107","1080","200","2387","49444","47","137","47137","2020"
"Census Tract 1020.03, Montgomery County, Tennessee","299","675","1009","162","2338","2145","193","1372","773","2338","62043","47","125","47125","2020"
"Census Tract 9251.02, Pickett County, Tennessee","480","186","196","69","1122","931","191","707","224","1122","33194","47","137","47137","2020"
"Census Tract 9501, Polk County, Tennessee","258","202","179","3","851","642","209","477","165","851","34694","47","139","47139","2020"
"Census Tract 9502.01, Polk County, Tennessee","270","418","115","75","1096","878","218","681","197","1096","47197","47","139","47139","2020"
"Census Tract 9502.03, Polk County, Tennessee","310","356","293","49","1151","1008","143","750","258","1151","46042","47","139","47139","2020"
"Census Tract 9502.04, Polk County, Tennessee","277","393","400","81","1419","1151","268","1012","139","1419","67981","47","139","47139","2020"
"Census Tract 9503, Polk County, Tennessee","748","679","347","75","2309","1849","460","1342","507","2309","45050","47","139","47139","2020"
"Census Tract 9504, Polk County, Tennessee","624","718","526","52","2250","1920","330","1282","638","2250","38194","47","139","47139","2020"
"Census Tract 167, Davidson County, Tennessee","326","1473","777","47","2947","2623","324","1480","1143","2947","114208","47","037","47037","2020"
"Census Tract 168, Davidson County, Tennessee","406","935","862","170","2586","2373","213","665","1708","2586","85299","47","037","47037","2020"
"Census Tract 169, Davidson County, Tennessee","195","1074","849","200","2483","2318","165","1445","873","2483","99722","47","037","47037","2020"
"Census Tract 170, Davidson County, Tennessee","150","665","381","96","1564","1292","272","770","522","1564","90000","47","037","47037","2020"
"Census Tract 171, Davidson County, Tennessee","166","805","563","46","1974","1580","394","692","888","1974","79300","47","037","47037","2020"
"Census Tract 172, Davidson County, Tennessee","88","318","186","33","726","625","101","342","283","726","61422","47","037","47037","2020"
"Census Tract 173, Davidson County, Tennessee","156","667","405","154","1494","1382","112","722","660","1494","35882","47","037","47037","2020"
"Census Tract 174.01, Davidson County, Tennessee","235","378","174","82","940","869","71","381","488","940","48717","47","037","47037","2020"
"Census Tract 174.02, Davidson County, Tennessee","390","1033","569","239","2649","2231","418","1075","1156","2649","47168","47","037","47037","2020"
"Census Tract 175, Davidson County, Tennessee","412","533","273","64","1421","1282","139","745","537","1421","43810","47","037","47037","2020"
"Census Tract 177.01, Davidson County, Tennessee","84","420","330","89","1020","923","97","784","139","1020","153750","47","037","47037","2020"
"Census Tract 177.02, Davidson County, Tennessee","322","557","593","117","1695","1589","106","1346","243","1695","115375","47","037","47037","2020"
"Census Tract 178, Davidson County, Tennessee","305","1095","1365","143","3174","2908","266","1623","1285","3174","96098","47","037","47037","2020"
"Census Tract 179.01, Davidson County, Tennessee","818","966","627","35","2753","2446","307","1850","596","2753","102969","47","037","47037","2020"
"Census Tract 179.02, Davidson County, Tennessee","714","993","682","72","2581","2461","120","1637","824","2581","110689","47","037","47037","2020"
"Census Tract 180, Davidson County, Tennessee","728","888","689","154","2919","2459","460","1809","650","2919","103979","47","037","47037","2020"
"Census Tract 181.01, Davidson County, Tennessee","443","1186","502","66","2351","2197","154","537","1660","2351","44194","47","037","47037","2020"
"Census Tract 181.02, Davidson County, Tennessee","635","832","532","40","2086","2039","47","1374","665","2086","97194","47","037","47037","2020"
"Census Tract 182.01, Davidson County, Tennessee","294","394","508","197","1444","1393","51","1019","374","1444","119031","47","037","47037","2020"
"Census Tract 182.03, Davidson County, Tennessee","109","244","228","11","633","592","41","583","9","633","180000","47","037","47037","2020"
"Census Tract 182.04, Davidson County, Tennessee","427","890","418","46","1958","1781","177","308","1473","1958","45080","47","037","47037","2020"
"Census Tract 182.05, Davidson County, Tennessee","313","833","535","114","1874","1795","79","681","1114","1874","77273","47","037","47037","2020"
"Census Tract 183.02, Davidson County, Tennessee","228","430","389","89","1143","1136","7","1010","126","1143","97330","47","037","47037","2020"
"Census Tract 183.03, Davidson County, Tennessee","213","1093","489","144","2243","1939","304","874","1065","2243","60144","47","037","47037","2020"
"Census Tract 183.04, Davidson County, Tennessee","259","571","656","179","1784","1665","119","1562","103","1784","110630","47","037","47037","2020"
"Census Tract 184.04, Davidson County, Tennessee","509","1130","630","89","2613","2358","255","1120","1238","2613","77635","47","037","47037","2020"
"Census Tract 184.05, Davidson County, Tennessee","382","797","649","104","1981","1932","49","1594","338","1981","91554","47","037","47037","2020"
"Census Tract 184.07, Davidson County, Tennessee","196","833","895","120","2044","2044","0","2015","29","2044","107132","47","037","47037","2020"
"Census Tract 184.08, Davidson County, Tennessee","233","405","494","126","1285","1258","27","1197","61","1285","112237","47","037","47037","2020"
"Census Tract 184.09, Davidson County, Tennessee","749","922","525","233","2574","2429","145","2012","417","2574","82626","47","037","47037","2020"
"Census Tract 184.10, Davidson County, Tennessee","448","659","443","83","1730","1633","97","685","948","1730","55492","47","037","47037","2020"
"Census Tract 184.11, Davidson County, Tennessee","202","510","494","81","1348","1287","61","663","624","1348","56116","47","037","47037","2020"
"Census Tract 184.12, Davidson County, Tennessee","418","817","543","202","2296","1980","316","1180","800","2296","73182","47","037","47037","2020"
"Census Tract 185, Davidson County, Tennessee","314","586","512","179","1668","1591","77","1402","189","1668","198112","47","037","47037","2020"
"Census Tract 186.01, Davidson County, Tennessee","171","386","266","21","861","844","17","817","27","861","199643","47","037","47037","2020"
"Census Tract 186.02, Davidson County, Tennessee","349","573","603","91","1695","1616","79","1579","37","1695","192500","47","037","47037","2020"
"Census Tract 187, Davidson County, Tennessee","215","486","560","14","1400","1275","125","1249","26","1400","186960","47","037","47037","2020"
"Census Tract 188.01, Davidson County, Tennessee","377","856","917","100","2404","2250","154","1715","535","2404","96942","47","037","47037","2020"
"Census Tract 188.03, Davidson County, Tennessee","302","1006","677","0","2187","1985","202","1131","854","2187","74466","47","037","47037","2020"
"Census Tract 188.04, Davidson County, Tennessee","258","979","882","158","2402","2277","125","1846","431","2402","115073","47","037","47037","2020"
"Census Tract 189.01, Davidson County, Tennessee","446","611","403","60","1699","1520","179","594","926","1699","47500","47","037","47037","2020"
"Census Tract 189.02, Davidson County, Tennessee","283","677","364","134","1559","1458","101","608","850","1559","75286","47","037","47037","2020"
"Census Tract 189.04, Davidson County, Tennessee","152","424","582","163","1518","1321","197","604","717","1518","61750","47","037","47037","2020"
"Census Tract 189.05, Davidson County, Tennessee","89","925","308","56","1553","1378","175","463","915","1553","65960","47","037","47037","2020"
"Census Tract 190.03, Davidson County, Tennessee","147","717","549","180","1851","1593","258","541","1052","1851","44349","47","037","47037","2020"
"Census Tract 2.01, Putnam County, Tennessee","783","1273","559","146","2761","2761","0","1581","1180","2761","38703","47","141","47141","2020"
"Census Tract 2.02, Putnam County, Tennessee","866","757","303","56","1982","1982","0","1715","267","1982","35667","47","141","47141","2020"
"Census Tract 3.01, Putnam County, Tennessee","314","458","379","80","1543","1231","312","1106","125","1543","55026","47","141","47141","2020"
"Census Tract 3.03, Putnam County, Tennessee","353","316","179","30","1044","878","166","482","396","1044","30417","47","141","47141","2020"
"Census Tract 3.04, Putnam County, Tennessee","477","629","482","140","1874","1728","146","365","1363","1874","26553","47","141","47141","2020"
"Census Tract 3.05, Putnam County, Tennessee","148","593","500","69","1471","1310","161","617","693","1471","37000","47","141","47141","2020"
"Census Tract 4, Putnam County, Tennessee","573","578","639","71","2035","1861","174","1016","845","2035","51694","47","141","47141","2020"
"Census Tract 5, Putnam County, Tennessee","226","584","240","75","1182","1125","57","458","667","1182","46706","47","141","47141","2020"
"Census Tract 6, Putnam County, Tennessee","672","378","589","37","1913","1676","237","968","708","1913","46154","47","141","47141","2020"
"Census Tract 7, Putnam County, Tennessee","575","630","409","106","1801","1720","81","398","1322","1801","37994","47","141","47141","2020"
"Census Tract 8, Putnam County, Tennessee","581","792","306","99","2079","1778","301","445","1333","2079","26376","47","141","47141","2020"
"Census Tract 9, Putnam County, Tennessee","629","891","784","203","2682","2507","175","1940","567","2682","56922","47","141","47141","2020"
"Census Tract 10, Putnam County, Tennessee","631","467","344","91","1684","1533","151","1394","139","1684","52309","47","141","47141","2020"
"Census Tract 11, Putnam County, Tennessee","708","1129","600","223","3121","2660","461","2121","539","3121","45381","47","141","47141","2020"
"Census Tract 12.01, Putnam County, Tennessee","528","901","905","107","2530","2441","89","1867","574","2530","58397","47","141","47141","2020"
"Census Tract 12.02, Putnam County, Tennessee","323","764","445","26","1710","1558","152","1018","540","1710","50862","47","141","47141","2020"
"Census Tract 13, Putnam County, Tennessee","322","471","174","68","1153","1035","118","880","155","1153","60379","47","141","47141","2020"
"Census Tract 9750, Rhea County, Tennessee","796","731","243","182","2625","1952","673","1503","449","2625","43495","47","143","47143","2020"
"Census Tract 9751, Rhea County, Tennessee","978","713","284","64","2477","2039","438","1695","344","2477","50927","47","143","47143","2020"
"Census Tract 9752, Rhea County, Tennessee","720","952","636","137","2660","2445","215","1953","492","2660","56677","47","143","47143","2020"
"Census Tract 9753, Rhea County, Tennessee","1016","730","545","109","2798","2400","398","1871","529","2798","43905","47","143","47143","2020"
"Census Tract 9754.01, Rhea County, Tennessee","996","729","453","115","2742","2293","449","1136","1157","2742","35276","47","143","47143","2020"
"Census Tract 9754.02, Rhea County, Tennessee","290","444","407","54","1480","1195","285","927","268","1480","61360","47","143","47143","2020"
"Census Tract 301, Roane County, Tennessee","346","413","435","52","1397","1246","151","1126","120","1397","108750","47","145","47145","2020"
"Census Tract 302.03, Roane County, Tennessee","539","309","469","135","1813","1452","361","1107","345","1813","73370","47","145","47145","2020"
"Census Tract 302.04, Roane County, Tennessee","560","589","254","127","1670","1530","140","927","603","1670","43771","47","145","47145","2020"
"Census Tract 302.05, Roane County, Tennessee","300","567","368","0","1330","1235","95","1141","94","1330","81891","47","145","47145","2020"
"Census Tract 302.06, Roane County, Tennessee","421","662","409","36","1746","1528","218","1242","286","1746","75000","47","145","47145","2020"
"Census Tract 303.01, Roane County, Tennessee","567","352","457","0","1880","1376","504","1109","267","1880","55250","47","145","47145","2020"
"Census Tract 303.02, Roane County, Tennessee","539","334","223","35","1472","1131","341","1078","53","1472","65694","47","145","47145","2020"
"Census Tract 304.01, Roane County, Tennessee","231","520","70","198","1358","1019","339","897","122","1358","51332","47","145","47145","2020"
"Census Tract 304.02, Roane County, Tennessee","366","485","347","42","1518","1240","278","1066","174","1518","62538","47","145","47145","2020"
"Census Tract 305, Roane County, Tennessee","737","475","411","73","1984","1696","288","857","839","1984","35350","47","145","47145","2020"
"Census Tract 306, Roane County, Tennessee","622","482","233","133","1833","1470","363","1059","411","1833","46429","47","145","47145","2020"
"Census Tract 307, Roane County, Tennessee","657","637","471","9","2130","1774","356","1335","439","2130","42917","47","145","47145","2020"
"Census Tract 308.01, Roane County, Tennessee","460","436","106","47","1295","1049","246","540","509","1295","29214","47","145","47145","2020"
"Census Tract 308.02, Roane County, Tennessee","459","379","372","63","1480","1273","207","861","412","1480","52744","47","145","47145","2020"
"Census Tract 1, Putnam County, Tennessee","683","669","458","183","2311","1993","318","1310","683","2311","43528","47","141","47141","2020"
"Census Tract 309, Roane County, Tennessee","972","686","770","149","2784","2577","207","1992","585","2784","62477","47","145","47145","2020"
"Census Tract 9801, Roane County, Tennessee","0","0","0","0","0","0","0","0","0","0","-666666666","47","145","47145","2020"
"Census Tract 801.01, Robertson County, Tennessee","391","539","640","190","1855","1760","95","1444","316","1855","67407","47","147","47147","2020"
"Census Tract 801.03, Robertson County, Tennessee","363","945","1022","164","2553","2494","59","1799","695","2553","78731","47","147","47147","2020"
"Census Tract 801.04, Robertson County, Tennessee","712","899","1046","244","2914","2901","13","2520","381","2914","65921","47","147","47147","2020"
"Census Tract 802, Robertson County, Tennessee","479","495","965","144","2441","2083","358","1630","453","2441","63967","47","147","47147","2020"
"Census Tract 803.01, Robertson County, Tennessee","210","375","256","84","950","925","25","560","365","950","50169","47","147","47147","2020"
"Census Tract 803.02, Robertson County, Tennessee","326","584","212","99","1389","1221","168","443","778","1389","34115","47","147","47147","2020"
"Census Tract 201, Anderson County, Tennessee","585","692","207","46","1828","1530","298","446","1084","1828","25895","47","001","47001","2010"
"Census Tract 202.01, Anderson County, Tennessee","409","639","348","126","1578","1522","56","1062","460","1578","72875","47","001","47001","2010"
"Census Tract 202.02, Anderson County, Tennessee","846","719","373","0","2077","1938","139","1327","611","2077","48953","47","001","47001","2010"
"Census Tract 203, Anderson County, Tennessee","559","658","405","110","1918","1732","186","1320","412","1918","50931","47","001","47001","2010"
"Census Tract 204, Anderson County, Tennessee","854","893","329","84","2519","2160","359","1450","710","2519","42563","47","001","47001","2010"
"Census Tract 205, Anderson County, Tennessee","492","546","224","63","1807","1325","482","681","644","1807","33083","47","001","47001","2010"
"Census Tract 206, Anderson County, Tennessee","334","387","299","27","1047","1047","0","949","98","1047","67279","47","001","47001","2010"
"Census Tract 207, Anderson County, Tennessee","269","250","101","50","803","670","133","559","111","803","30139","47","001","47001","2010"
"Census Tract 208, Anderson County, Tennessee","939","520","482","53","2408","1994","414","1490","504","2408","29663","47","001","47001","2010"
"Census Tract 209.01, Anderson County, Tennessee","814","672","653","40","2602","2179","423","1840","339","2602","47204","47","001","47001","2010"
"Census Tract 209.02, Anderson County, Tennessee","624","885","587","120","2504","2216","288","1937","279","2504","51106","47","001","47001","2010"
"Census Tract 210, Anderson County, Tennessee","977","831","591","54","2825","2453","372","1960","493","2825","34144","47","001","47001","2010"
"Census Tract 211, Anderson County, Tennessee","450","578","476","75","1705","1579","126","1305","274","1705","62737","47","001","47001","2010"
"Census Tract 212.01, Anderson County, Tennessee","555","691","631","72","2073","1949","124","1560","389","2073","47319","47","001","47001","2010"
"Census Tract 212.02, Anderson County, Tennessee","1145","1041","325","28","2561","2539","22","959","1580","2561","28927","47","001","47001","2010"
"Census Tract 213.01, Anderson County, Tennessee","361","483","375","106","1353","1325","28","1149","176","1353","52083","47","001","47001","2010"
"Census Tract 213.02, Anderson County, Tennessee","933","750","917","181","2901","2781","120","2208","573","2901","47928","47","001","47001","2010"
"Census Tract 9801, Anderson County, Tennessee","0","0","0","0","0","0","0","0","0","0","-666666666","47","001","47001","2010"
"Census Tract 9501, Bedford County, Tennessee","303","492","460","131","1515","1386","129","1215","171","1515","52440","47","003","47003","2010"
"Census Tract 9502, Bedford County, Tennessee","572","1057","546","268","2807","2443","364","2060","383","2807","46203","47","003","47003","2010"
"Census Tract 9503, Bedford County, Tennessee","396","434","433","86","1488","1349","139","1129","220","1488","42482","47","003","47003","2010"
"Census Tract 9504.01, Bedford County, Tennessee","499","641","474","203","2059","1817","242","1087","730","2059","37908","47","003","47003","2010"
"Census Tract 9504.02, Bedford County, Tennessee","797","983","510","137","2697","2427","270","1245","1182","2697","23964","47","003","47003","2010"
"Census Tract 9505, Bedford County, Tennessee","705","726","522","108","2266","2061","205","1246","815","2266","38201","47","003","47003","2010"
"Census Tract 9506, Bedford County, Tennessee","728","1042","599","59","2837","2428","409","1289","1139","2837","31099","47","003","47003","2010"
"Census Tract 9507, Bedford County, Tennessee","250","374","275","11","991","910","81","697","213","991","43750","47","003","47003","2010"
"Census Tract 9508, Bedford County, Tennessee","360","330","400","94","1286","1184","102","1009","175","1286","47935","47","003","47003","2010"
"Census Tract 9630, Benton County, Tennessee","617","555","248","45","2059","1465","594","1219","246","2059","32363","47","005","47005","2010"
"Census Tract 9631, Benton County, Tennessee","526","395","344","39","1688","1304","384","1215","89","1688","40000","47","005","47005","2010"
"Census Tract 9632, Benton County, Tennessee","329","388","96","16","1353","829","524","694","135","1353","35477","47","005","47005","2010"
"Census Tract 9633, Benton County, Tennessee","748","560","249","78","1869","1635","234","1103","532","1869","27961","47","005","47005","2010"
"Census Tract 9634, Benton County, Tennessee","656","553","403","135","2018","1747","271","1575","172","2018","36016","47","005","47005","2010"
"Census Tract 9530, Bledsoe County, Tennessee","512","445","178","70","1653","1205","448","960","245","1653","32639","47","007","47007","2010"
"Census Tract 9531, Bledsoe County, Tennessee","915","638","523","69","2566","2145","421","1493","652","2566","29383","47","007","47007","2010"
"Census Tract 9532, Bledsoe County, Tennessee","399","468","200","13","1438","1080","358","947","133","1438","27500","47","007","47007","2010"
"Census Tract 101, Blount County, Tennessee","256","361","327","107","1266","1051","215","519","532","1266","41036","47","009","47009","2010"
"Census Tract 102, Blount County, Tennessee","723","805","427","89","2394","2044","350","1754","290","2394","45733","47","009","47009","2010"
"Census Tract 103.01, Blount County, Tennessee","703","896","545","94","2710","2238","472","1094","1144","2710","36532","47","009","47009","2010"
"Census Tract 103.02, Blount County, Tennessee","423","318","635","22","1522","1398","124","968","430","1522","50652","47","009","47009","2010"
"Census Tract 104, Blount County, Tennessee","380","427","402","64","1495","1273","222","924","349","1495","49850","47","009","47009","2010"
"Census Tract 105, Blount County, Tennessee","464","536","262","42","1433","1304","129","443","861","1433","22750","47","009","47009","2010"
"Census Tract 106, Blount County, Tennessee","567","606","331","46","1649","1550","99","638","912","1649","39375","47","009","47009","2010"
"Census Tract 107, Blount County, Tennessee","456","751","694","58","2104","1959","145","1568","391","2104","49557","47","009","47009","2010"
"Census Tract 108, Blount County, Tennessee","279","524","365","31","1478","1199","279","582","617","1478","30674","47","009","47009","2010"
"Census Tract 109, Blount County, Tennessee","584","825","726","267","2476","2402","74","1974","428","2476","52353","47","009","47009","2010"
"Census Tract 110.01, Blount County, Tennessee","829","847","545","93","2446","2314","132","1785","529","2446","37773","47","009","47009","2010"
"Census Tract 110.02, Blount County, Tennessee","584","516","526","48","1721","1674","47","1451","223","1721","50208","47","009","47009","2010"
"Census Tract 111.01, Blount County, Tennessee","502","774","582","187","2178","2045","133","1745","300","2178","51115","47","009","47009","2010"
"Census Tract 111.02, Blount County, Tennessee","978","939","1085","138","3420","3140","280","2788","352","3420","75551","47","009","47009","2010"
"Census Tract 112, Blount County, Tennessee","1029","1109","712","163","3382","3013","369","1885","1128","3382","38177","47","009","47009","2010"
"Census Tract 113.01, Blount County, Tennessee","445","773","874","50","2245","2142","103","1889","253","2245","52984","47","009","47009","2010"
"Census Tract 113.02, Blount County, Tennessee","658","771","562","93","2211","2084","127","1784","300","2211","40758","47","009","47009","2010"
"Census Tract 114.01, Blount County, Tennessee","217","392","201","24","1092","834","258","634","200","1092","39013","47","009","47009","2010"
"Census Tract 114.02, Blount County, Tennessee","568","646","322","83","2843","1619","1224","1408","211","2843","38366","47","009","47009","2010"
"Census Tract 115.01, Blount County, Tennessee","189","206","186","81","810","662","148","529","133","810","39944","47","009","47009","2010"
"Census Tract 115.02, Blount County, Tennessee","516","683","342","63","1667","1604","63","1237","367","1667","46964","47","009","47009","2010"
"Census Tract 115.03, Blount County, Tennessee","813","823","671","231","2815","2538","277","2163","375","2815","50000","47","009","47009","2010"
"Census Tract 116.02, Blount County, Tennessee","922","1290","1077","207","3649","3496","153","2964","532","3649","52640","47","009","47009","2010"
"Census Tract 116.03, Blount County, Tennessee","387","638","739","92","2109","1856","253","1493","363","2109","49364","47","009","47009","2010"
"Census Tract 116.04, Blount County, Tennessee","316","430","401","77","1482","1224","258","1052","172","1482","57262","47","009","47009","2010"
"Census Tract 116.05, Blount County, Tennessee","373","684","356","39","1619","1452","167","1350","102","1619","57000","47","009","47009","2010"
"Census Tract 9801, Blount County, Tennessee","0","0","12","0","12","12","0","12","0","12","-666666666","47","009","47009","2010"
"Census Tract 9802, Blount County, Tennessee","15","9","0","0","24","24","0","9","15","24","22000","47","009","47009","2010"
"Census Tract 101, Bradley County, Tennessee","653","695","614","34","2137","1996","141","1159","837","2137","39142","47","011","47011","2010"
"Census Tract 102, Bradley County, Tennessee","651","972","498","62","2407","2183","224","1101","1082","2407","41988","47","011","47011","2010"
"Census Tract 103, Bradley County, Tennessee","349","354","292","20","1076","1015","61","514","501","1076","28965","47","011","47011","2010"
"Census Tract 104, Bradley County, Tennessee","631","234","139","64","1266","1068","198","274","794","1266","13391","47","011","47011","2010"
"Census Tract 105, Bradley County, Tennessee","215","535","186","29","1183","965","218","353","612","1183","31359","47","011","47011","2010"
"Census Tract 106, Bradley County, Tennessee","484","683","243","12","1549","1422","127","790","632","1549","39057","47","011","47011","2010"
"Census Tract 107, Bradley County, Tennessee","732","667","390","62","2002","1851","151","693","1158","2002","26422","47","011","47011","2010"
"Census Tract 108, Bradley County, Tennessee","485","510","218","33","1488","1246","242","433","813","1488","19510","47","011","47011","2010"
"Census Tract 109, Bradley County, Tennessee","482","438","295","16","1231","1231","0","973","258","1231","31191","47","011","47011","2010"
"Census Tract 110, Bradley County, Tennessee","582","948","521","141","2439","2192","247","1685","507","2439","34250","47","011","47011","2010"
"Census Tract 111, Bradley County, Tennessee","732","1425","906","293","3548","3356","192","2843","513","3548","43806","47","011","47011","2010"
"Census Tract 112.01, Bradley County, Tennessee","512","662","824","81","2376","2079","297","1731","348","2376","52930","47","011","47011","2010"
"Census Tract 112.02, Bradley County, Tennessee","623","1304","971","162","3330","3060","270","2137","923","3330","54699","47","011","47011","2010"
"Census Tract 113, Bradley County, Tennessee","874","1052","613","232","2966","2771","195","2551","220","2966","46250","47","011","47011","2010"
"Census Tract 114.01, Bradley County, Tennessee","622","1281","1094","106","3293","3103","190","2311","792","3293","52588","47","011","47011","2010"
"Census Tract 114.02, Bradley County, Tennessee","195","534","411","104","1537","1244","293","518","726","1537","35745","47","011","47011","2010"
"Census Tract 115, Bradley County, Tennessee","992","950","729","258","3140","2929","211","2306","623","3140","41388","47","011","47011","2010"
"Census Tract 116.01, Bradley County, Tennessee","598","598","592","135","1966","1923","43","1561","362","1966","39258","47","011","47011","2010"
"Census Tract 116.02, Bradley County, Tennessee","533","775","477","57","1978","1842","136","1420","422","1978","41532","47","011","47011","2010"
"Census Tract 9501, Campbell County, Tennessee","547","368","266","29","1494","1210","284","993","217","1494","30865","47","013","47013","2010"
"Census Tract 9502, Campbell County, Tennessee","547","246","198","29","1227","1020","207","736","284","1227","26136","47","013","47013","2010"
"Census Tract 9503, Campbell County, Tennessee","270","227","132","16","763","645","118","521","124","763","24375","47","013","47013","2010"
"Census Tract 9504, Campbell County, Tennessee","615","591","427","76","2114","1709","405","1274","435","2114","36113","47","013","47013","2010"
"Census Tract 9505, Campbell County, Tennessee","786","612","536","91","2376","2025","351","1389","636","2376","31740","47","013","47013","2010"
"Census Tract 9506, Campbell County, Tennessee","988","606","237","20","2187","1851","336","925","926","2187","20591","47","013","47013","2010"
"Census Tract 9507, Campbell County, Tennessee","932","788","285","41","2325","2046","279","1126","920","2325","25078","47","013","47013","2010"
"Census Tract 9508, Campbell County, Tennessee","451","300","180","0","1317","931","386","825","106","1317","32583","47","013","47013","2010"
"Census Tract 9509, Campbell County, Tennessee","551","416","203","24","1838","1194","644","1005","189","1838","27456","47","013","47013","2010"
"Census Tract 9510, Campbell County, Tennessee","522","319","162","24","1279","1027","252","797","230","1279","33534","47","013","47013","2010"
"Census Tract 9511, Campbell County, Tennessee","795","763","458","117","2734","2133","601","1775","358","2734","40946","47","013","47013","2010"
"Census Tract 9601, Cannon County, Tennessee","419","567","426","96","1689","1508","181","1105","403","1689","43343","47","015","47015","2010"
"Census Tract 9602, Cannon County, Tennessee","925","937","595","69","2853","2526","327","1849","677","2853","36374","47","015","47015","2010"
"Census Tract 9603, Cannon County, Tennessee","433","452","370","32","1427","1287","140","1102","185","1427","38364","47","015","47015","2010"
"Census Tract 9620, Carroll County, Tennessee","667","567","272","32","1955","1538","417","1288","250","1955","32083","47","017","47017","2010"
"Census Tract 9621, Carroll County, Tennessee","858","1060","587","235","3436","2740","696","2149","591","3436","39452","47","017","47017","2010"
"Census Tract 9622.01, Carroll County, Tennessee","726","596","218","22","1644","1562","82","1028","534","1644","28310","47","017","47017","2010"
"Census Tract 9622.02, Carroll County, Tennessee","473","440","676","50","1886","1639","247","1178","461","1886","49844","47","017","47017","2010"
"Census Tract 9623, Carroll County, Tennessee","611","694","297","141","2064","1743","321","1371","372","2064","30685","47","017","47017","2010"
"Census Tract 9624, Carroll County, Tennessee","309","388","265","54","1229","1016","213","829","187","1229","36955","47","017","47017","2010"
"Census Tract 9625, Carroll County, Tennessee","306","260","236","50","995","852","143","725","127","995","36818","47","017","47017","2010"
"Census Tract 9801, Carroll County, Tennessee","0","0","0","0","0","0","0","0","0","0","-666666666","47","017","47017","2010"
"Census Tract 701, Carter County, Tennessee","413","310","62","5","941","790","151","377","413","941","23333","47","019","47019","2010"
"Census Tract 702, Carter County, Tennessee","529","585","403","47","1604","1564","40","1150","414","1604","40577","47","019","47019","2010"
"Census Tract 703, Carter County, Tennessee","871","712","477","143","2616","2203","413","1233","970","2616","22793","47","019","47019","2010"
"Census Tract 704, Carter County, Tennessee","474","224","139","42","929","879","50","615","264","929","22548","47","019","47019","2010"
"Census Tract 705, Carter County, Tennessee","829","775","281","76","2057","1961","96","1435","526","2057","31750","47","019","47019","2010"
"Census Tract 706, Carter County, Tennessee","493","465","161","56","1245","1175","70","974","201","1245","34340","47","019","47019","2010"
"Census Tract 707, Carter County, Tennessee","371","583","347","106","1598","1407","191","1183","224","1598","46807","47","019","47019","2010"
"Census Tract 708, Carter County, Tennessee","416","588","305","94","1483","1403","80","925","478","1483","37450","47","019","47019","2010"
"Census Tract 709, Carter County, Tennessee","341","449","407","119","1479","1316","163","822","494","1479","43555","47","019","47019","2010"
"Census Tract 710, Carter County, Tennessee","427","598","236","18","1464","1279","185","796","483","1464","28445","47","019","47019","2010"
"Census Tract 711, Carter County, Tennessee","255","250","248","54","841","807","34","640","167","841","31583","47","019","47019","2010"
"Census Tract 712, Carter County, Tennessee","649","667","338","32","1899","1686","213","1356","330","1899","28633","47","019","47019","2010"
"Census Tract 713, Carter County, Tennessee","1129","913","612","175","3434","2829","605","2398","431","3434","37065","47","019","47019","2010"
"Census Tract 714, Carter County, Tennessee","529","597","406","35","1904","1567","337","1077","490","1904","26891","47","019","47019","2010"
"Census Tract 715, Carter County, Tennessee","405","372","139","29","1184","945","239","856","89","1184","23641","47","019","47019","2010"
"Census Tract 716, Carter County, Tennessee","261","305","76","12","893","654","239","522","132","893","22073","47","019","47019","2010"
"Census Tract 717, Carter County, Tennessee","598","430","353","87","2009","1468","541","1184","284","2009","32744","47","019","47019","2010"
"Census Tract 701.02, Cheatham County, Tennessee","339","686","548","52","1701","1625","76","1365","260","1701","47560","47","021","47021","2010"
"Census Tract 701.03, Cheatham County, Tennessee","232","423","526","37","1404","1218","186","972","246","1404","59128","47","021","47021","2010"
"Census Tract 701.04, Cheatham County, Tennessee","540","809","457","96","2255","1902","353","1486","416","2255","37652","47","021","47021","2010"
"Census Tract 702.01, Cheatham County, Tennessee","259","505","569","81","1532","1414","118","1346","68","1532","75536","47","021","47021","2010"
"Census Tract 702.02, Cheatham County, Tennessee","450","502","522","290","1950","1764","186","1351","413","1950","65210","47","021","47021","2010"
"Census Tract 702.03, Cheatham County, Tennessee","262","546","462","75","1423","1345","78","1124","221","1423","54007","47","021","47021","2010"
"Census Tract 703, Cheatham County, Tennessee","351","509","281","41","1291","1182","109","671","511","1291","36974","47","021","47021","2010"
"Census Tract 704.01, Cheatham County, Tennessee","216","373","388","78","1113","1055","58","886","169","1113","53945","47","021","47021","2010"
"Census Tract 704.02, Cheatham County, Tennessee","465","925","1110","193","2756","2693","63","2282","411","2756","64867","47","021","47021","2010"
"Census Tract 9701, Chester County, Tennessee","556","803","685","19","2528","2063","465","1712","351","2528","38352","47","023","47023","2010"
"Census Tract 9702, Chester County, Tennessee","514","697","304","115","1786","1630","156","845","785","1786","35735","47","023","47023","2010"
"Census Tract 9703, Chester County, Tennessee","786","667","731","110","2592","2294","298","1888","406","2592","45537","47","023","47023","2010"
"Census Tract 9701, Claiborne County, Tennessee","432","434","164","69","1241","1099","142","944","155","1241","34426","47","025","47025","2010"
"Census Tract 9702, Claiborne County, Tennessee","472","435","236","47","1384","1190","194","919","271","1384","38533","47","025","47025","2010"
"Census Tract 9703, Claiborne County, Tennessee","499","558","329","55","1569","1441","128","1142","299","1569","36118","47","025","47025","2010"
"Census Tract 9704, Claiborne County, Tennessee","149","115","25","0","360","289","71","289","0","360","19770","47","025","47025","2010"
"Census Tract 9705, Claiborne County, Tennessee","469","419","205","29","1416","1122","294","904","218","1416","29079","47","025","47025","2010"
"Census Tract 9706, Claiborne County, Tennessee","633","481","641","48","2205","1803","402","1553","250","2205","36306","47","025","47025","2010"
"Census Tract 9707, Claiborne County, Tennessee","926","1026","477","67","2800","2496","304","1664","832","2800","30741","47","025","47025","2010"
"Census Tract 9708, Claiborne County, Tennessee","649","335","285","53","1548","1322","226","1131","191","1548","26500","47","025","47025","2010"
"Census Tract 9709, Claiborne County, Tennessee","804","703","212","31","2228","1750","478","1120","630","2228","26218","47","025","47025","2010"
"Census Tract 9550, Clay County, Tennessee","970","642","572","54","2988","2238","750","1753","485","2988","31977","47","027","47027","2010"
"Census Tract 9551, Clay County, Tennessee","596","463","254","70","1599","1383","216","1069","314","1599","32292","47","027","47027","2010"
"Census Tract 9201, Cocke County, Tennessee","753","395","441","37","1809","1626","183","1393","233","1809","35980","47","029","47029","2010"
"Census Tract 9202, Cocke County, Tennessee","958","718","532","49","2647","2257","390","1396","861","2647","25548","47","029","47029","2010"
"Census Tract 9203, Cocke County, Tennessee","560","471","409","111","1846","1551","295","1293","258","1846","38777","47","029","47029","2010"
"Census Tract 9204, Cocke County, Tennessee","389","256","118","57","1029","820","209","700","120","1029","30140","47","029","47029","2010"
"Census Tract 9205.01, Cocke County, Tennessee","1175","955","416","26","2963","2572","391","1627","945","2963","19662","47","029","47029","2010"
"Census Tract 9205.02, Cocke County, Tennessee","683","798","524","108","2395","2113","282","1815","298","2395","34727","47","029","47029","2010"
"Census Tract 9206, Cocke County, Tennessee","910","566","346","134","2296","1956","340","1261","695","2296","28722","47","029","47029","2010"
"Census Tract 9207, Cocke County, Tennessee","660","763","390","34","2278","1847","431","1286","561","2278","26996","47","029","47029","2010"
"Census Tract 9801, Cocke County, Tennessee","0","0","15","0","15","15","0","0","15","15","-666666666","47","029","47029","2010"
"Census Tract 9701, Coffee County, Tennessee","470","415","418","116","1666","1419","247","1165","254","1666","43725","47","031","47031","2010"
"Census Tract 9702, Coffee County, Tennessee","1081","1050","669","35","3086","2835","251","2184","651","3086","38201","47","031","47031","2010"
"Census Tract 9703, Coffee County, Tennessee","244","271","179","63","787","757","30","654","103","787","45905","47","031","47031","2010"
"Census Tract 9704, Coffee County, Tennessee","665","795","734","64","2619","2258","361","1872","386","2619","41205","47","031","47031","2010"
"Census Tract 9705, Coffee County, Tennessee","663","839","465","140","2293","2107","186","1341","766","2293","45547","47","031","47031","2010"
"Census Tract 9706, Coffee County, Tennessee","510","574","513","46","1752","1643","109","1073","570","1752","39950","47","031","47031","2010"
"Census Tract 9707, Coffee County, Tennessee","590","659","301","51","1770","1601","169","1306","295","1770","37520","47","031","47031","2010"
"Census Tract 9708.01, Coffee County, Tennessee","578","505","500","65","1842","1648","194","926","722","1842","35644","47","031","47031","2010"
"Census Tract 9708.02, Coffee County, Tennessee","751","915","674","96","2610","2436","174","1987","449","2610","51222","47","031","47031","2010"
"Census Tract 9709, Coffee County, Tennessee","722","667","211","71","1941","1671","270","753","918","1941","19991","47","031","47031","2010"
"Census Tract 9710, Coffee County, Tennessee","716","987","681","110","2668","2494","174","1819","675","2668","43910","47","031","47031","2010"
"Census Tract 9801, Coffee County, Tennessee","0","0","0","0","0","0","0","0","0","0","-666666666","47","031","47031","2010"
"Census Tract 9610, Crockett County, Tennessee","246","301","313","11","951","871","80","583","288","951","45503","47","033","47033","2010"
"Census Tract 9611, Crockett County, Tennessee","589","565","332","105","1815","1591","224","1072","519","1815","32558","47","033","47033","2010"
"Census Tract 9612, Crockett County, Tennessee","191","251","270","23","819","735","84","534","201","819","39375","47","033","47033","2010"
"Census Tract 9613, Crockett County, Tennessee","358","326","263","50","1140","997","143","685","312","1140","32356","47","033","47033","2010"
"Census Tract 9614, Crockett County, Tennessee","308","496","506","45","1667","1355","312","927","428","1667","42917","47","033","47033","2010"
"Census Tract 9701.01, Cumberland County, Tennessee","1076","225","131","0","1850","1432","418","1260","172","1850","52287","47","035","47035","2010"
"Census Tract 9701.02, Cumberland County, Tennessee","1566","818","297","59","3239","2740","499","2453","287","3239","39850","47","035","47035","2010"
"Census Tract 9702, Cumberland County, Tennessee","931","743","515","81","2699","2270","429","1857","413","2699","40853","47","035","47035","2010"
"Census Tract 9703.01, Cumberland County, Tennessee","327","553","240","44","1461","1164","297","972","192","1461","35084","47","035","47035","2010"
"Census Tract 9703.02, Cumberland County, Tennessee","845","653","330","39","2129","1867","262","1628","239","2129","29032","47","035","47035","2010"
"Census Tract 9704, Cumberland County, Tennessee","1206","829","378","68","2850","2481","369","1142","1339","2850","24071","47","035","47035","2010"
"Census Tract 9705.01, Cumberland County, Tennessee","263","450","397","55","1314","1165","149","841","324","1314","41518","47","035","47035","2010"
"Census Tract 9705.02, Cumberland County, Tennessee","644","465","411","38","1763","1558","205","876","682","1763","28986","47","035","47035","2010"
"Census Tract 9706.01, Cumberland County, Tennessee","744","550","467","200","2171","1961","210","1713","248","2171","50240","47","035","47035","2010"
"Census Tract 9706.02, Cumberland County, Tennessee","564","490","193","31","1415","1278","137","1040","238","1415","40133","47","035","47035","2010"
"Census Tract 9706.03, Cumberland County, Tennessee","273","358","213","32","913","876","37","780","96","913","42073","47","035","47035","2010"
"Census Tract 46.10, Knox County, Tennessee","340","1420","602","13","2671","2375","296","375","2000","2671","32356","47","093","47093","2010"
"Census Tract 46.11, Knox County, Tennessee","288","575","614","57","1673","1534","139","1431","103","1673","94022","47","093","47093","2010"
"Census Tract 46.12, Knox County, Tennessee","129","547","248","62","1082","986","96","725","261","1082","61919","47","093","47093","2010"
"Census Tract 46.13, Knox County, Tennessee","210","1185","601","124","2341","2120","221","1300","820","2341","48941","47","093","47093","2010"
"Census Tract 46.14, Knox County, Tennessee","253","668","435","38","1532","1394","138","852","542","1532","50160","47","093","47093","2010"
"Census Tract 46.15, Knox County, Tennessee","482","649","581","16","1862","1728","134","768","960","1862","48429","47","093","47093","2010"
"Census Tract 47, Knox County, Tennessee","565","562","506","34","1685","1667","18","1221","446","1685","46083","47","093","47093","2010"
"Census Tract 48, Knox County, Tennessee","468","1211","664","61","2539","2404","135","1934","470","2539","48889","47","093","47093","2010"
"Census Tract 49, Knox County, Tennessee","504","1064","720","123","2516","2411","105","1662","749","2516","48939","47","093","47093","2010"
"Census Tract 50, Knox County, Tennessee","410","949","472","66","2102","1897","205","1111","786","2102","41462","47","093","47093","2010"
"Census Tract 51, Knox County, Tennessee","378","1004","852","80","2422","2314","108","1927","387","2422","63663","47","093","47093","2010"
"Census Tract 52.01, Knox County, Tennessee","536","735","624","96","2098","1991","107","1661","330","2098","47793","47","093","47093","2010"
"Census Tract 52.02, Knox County, Tennessee","327","593","427","79","1501","1426","75","1159","267","1501","36161","47","093","47093","2010"
"Census Tract 53.01, Knox County, Tennessee","521","774","391","84","1861","1770","91","1348","422","1861","39508","47","093","47093","2010"
"Census Tract 53.02, Knox County, Tennessee","456","672","300","83","1616","1511","105","1251","260","1616","46880","47","093","47093","2010"
"Census Tract 54.01, Knox County, Tennessee","545","580","348","113","1614","1586","28","1200","386","1614","45750","47","093","47093","2010"
"Census Tract 54.02, Knox County, Tennessee","448","398","362","50","1380","1258","122","918","340","1380","38636","47","093","47093","2010"
"Census Tract 55.01, Knox County, Tennessee","214","507","297","48","1173","1066","107","859","207","1173","45357","47","093","47093","2010"
"Census Tract 55.02, Knox County, Tennessee","341","439","268","56","1212","1104","108","836","268","1212","44848","47","093","47093","2010"
"Census Tract 56.02, Knox County, Tennessee","451","661","553","82","1747","1747","0","1427","320","1747","51985","47","093","47093","2010"
"Census Tract 56.03, Knox County, Tennessee","444","505","541","58","1573","1548","25","1372","176","1573","56513","47","093","47093","2010"
"Census Tract 56.04, Knox County, Tennessee","240","497","243","90","1189","1070","119","825","245","1189","59815","47","093","47093","2010"
"Census Tract 57.01, Knox County, Tennessee","346","809","530","39","1865","1724","141","1451","273","1865","82093","47","093","47093","2010"
"Census Tract 57.04, Knox County, Tennessee","523","1289","760","87","2967","2659","308","1787","872","2967","56762","47","093","47093","2010"
"Census Tract 57.06, Knox County, Tennessee","268","474","564","77","1496","1383","113","1038","345","1496","74188","47","093","47093","2010"
"Census Tract 57.07, Knox County, Tennessee","164","370","476","73","1176","1083","93","971","112","1176","98018","47","093","47093","2010"
"Census Tract 57.08, Knox County, Tennessee","82","461","564","58","1165","1165","0","810","355","1165","81152","47","093","47093","2010"
"Census Tract 57.09, Knox County, Tennessee","55","181","413","35","684","684","0","684","0","684","120563","47","093","47093","2010"
"Census Tract 57.10, Knox County, Tennessee","118","479","223","34","906","854","52","760","94","906","115625","47","093","47093","2010"
"Census Tract 57.11, Knox County, Tennessee","202","747","788","167","2042","1904","138","1747","157","2042","86119","47","093","47093","2010"
"Census Tract 57.12, Knox County, Tennessee","388","1320","1266","106","3258","3080","178","2546","534","3258","102047","47","093","47093","2010"
"Census Tract 58.03, Knox County, Tennessee","244","429","338","65","1076","1076","0","876","200","1076","65000","47","093","47093","2010"
"Census Tract 58.07, Knox County, Tennessee","272","322","380","32","1061","1006","55","885","121","1061","95536","47","093","47093","2010"
"Census Tract 58.08, Knox County, Tennessee","420","929","646","35","2075","2030","45","1803","227","2075","70942","47","093","47093","2010"
"Census Tract 58.09, Knox County, Tennessee","467","994","405","78","2017","1944","73","1592","352","2017","91806","47","093","47093","2010"
"Census Tract 58.10, Knox County, Tennessee","263","476","300","77","1165","1116","49","1090","26","1165","116364","47","093","47093","2010"
"Census Tract 58.11, Knox County, Tennessee","80","313","391","109","893","893","0","885","8","893","126406","47","093","47093","2010"
"Census Tract 58.12, Knox County, Tennessee","164","584","644","37","1544","1429","115","1429","0","1544","133177","47","093","47093","2010"
"Census Tract 58.13, Knox County, Tennessee","500","660","680","117","2110","1957","153","1736","221","2110","86321","47","093","47093","2010"
"Census Tract 59.03, Knox County, Tennessee","250","728","332","61","1437","1371","66","1088","283","1437","49306","47","093","47093","2010"
"Census Tract 59.04, Knox County, Tennessee","312","595","503","304","1783","1714","69","1482","232","1783","76558","47","093","47093","2010"
"Census Tract 59.05, Knox County, Tennessee","37","278","233","80","725","628","97","530","98","725","82344","47","093","47093","2010"
"Census Tract 59.06, Knox County, Tennessee","88","112","328","8","536","536","0","460","76","536","82155","47","093","47093","2010"
"Census Tract 59.07, Knox County, Tennessee","182","385","378","5","1037","950","87","848","102","1037","84750","47","093","47093","2010"
"Census Tract 59.08, Knox County, Tennessee","296","691","526","107","1809","1620","189","1367","253","1809","53500","47","093","47093","2010"
"Census Tract 60.01, Knox County, Tennessee","208","761","318","22","1327","1309","18","833","476","1327","49763","47","093","47093","2010"
"Census Tract 60.02, Knox County, Tennessee","529","912","682","267","2534","2390","144","1978","412","2534","62551","47","093","47093","2010"
"Census Tract 60.03, Knox County, Tennessee","339","468","710","50","1567","1567","0","1383","184","1567","63218","47","093","47093","2010"
"Census Tract 61.02, Knox County, Tennessee","464","962","621","108","2209","2155","54","1693","462","2209","46265","47","093","47093","2010"
"Census Tract 61.03, Knox County, Tennessee","509","695","598","127","2083","1929","154","1573","356","2083","59125","47","093","47093","2010"
"Census Tract 61.04, Knox County, Tennessee","399","656","461","173","1951","1689","262","1452","237","1951","48342","47","093","47093","2010"
"Census Tract 62.02, Knox County, Tennessee","393","623","699","148","1978","1863","115","1537","326","1978","62549","47","093","47093","2010"
"Census Tract 62.03, Knox County, Tennessee","432","801","750","46","2104","2029","75","1278","751","2104","48263","47","093","47093","2010"
"Census Tract 62.05, Knox County, Tennessee","283","370","591","136","1504","1380","124","1253","127","1504","74615","47","093","47093","2010"
"Census Tract 62.06, Knox County, Tennessee","317","510","579","256","1662","1662","0","1602","60","1662","78431","47","093","47093","2010"
"Census Tract 62.07, Knox County, Tennessee","244","628","450","28","1372","1350","22","1042","308","1372","42303","47","093","47093","2010"
"Census Tract 62.08, Knox County, Tennessee","550","1099","450","62","2273","2161","112","1377","784","2273","31756","47","093","47093","2010"
"Census Tract 63.01, Knox County, Tennessee","353","400","375","147","1429","1275","154","1014","261","1429","50811","47","093","47093","2010"
"Census Tract 63.02, Knox County, Tennessee","308","439","330","88","1233","1165","68","950","215","1233","40995","47","093","47093","2010"
"Census Tract 64.01, Knox County, Tennessee","286","560","481","113","1531","1440","91","1263","177","1531","56888","47","093","47093","2010"
"Census Tract 64.02, Knox County, Tennessee","363","621","723","69","1818","1776","42","1593","183","1818","49566","47","093","47093","2010"
"Census Tract 64.03, Knox County, Tennessee","143","481","367","52","1098","1043","55","944","99","1098","53152","47","093","47093","2010"
"Census Tract 65.01, Knox County, Tennessee","404","377","486","20","1374","1287","87","1181","106","1374","53458","47","093","47093","2010"
"Census Tract 65.02, Knox County, Tennessee","421","538","239","82","1440","1280","160","1045","235","1440","47830","47","093","47093","2010"
"Census Tract 66, Knox County, Tennessee","561","703","266","19","1707","1549","158","575","974","1707","27524","47","093","47093","2010"
"Census Tract 67, Knox County, Tennessee","800","676","157","23","1812","1656","156","594","1062","1812","20357","47","093","47093","2010"
"Census Tract 68, Knox County, Tennessee","1593","599","123","7","2619","2322","297","352","1970","2619","7053","47","093","47093","2010"
"Census Tract 69, Knox County, Tennessee","957","1577","229","108","3429","2871","558","256","2615","3429","8873","47","093","47093","2010"
"Census Tract 70, Knox County, Tennessee","414","480","108","8","1096","1010","86","469","541","1096","21508","47","093","47093","2010"
"Census Tract 71, Knox County, Tennessee","464","713","480","55","1947","1712","235","1176","536","1947","76800","47","093","47093","2010"
"Census Tract 9601, Lake County, Tennessee","608","528","157","54","1537","1347","190","819","528","1537","25288","47","095","47095","2010"
"Census Tract 9602, Lake County, Tennessee","458","338","135","22","1085","953","132","599","354","1085","24226","47","095","47095","2010"
"Census Tract 501, Lauderdale County, Tennessee","230","198","129","14","786","571","215","364","207","786","31699","47","097","47097","2010"
"Census Tract 502, Lauderdale County, Tennessee","537","481","388","29","1633","1435","198","955","480","1633","38125","47","097","47097","2010"
"Census Tract 503, Lauderdale County, Tennessee","333","473","253","30","1244","1089","155","810","279","1244","33355","47","097","47097","2010"
"Census Tract 504, Lauderdale County, Tennessee","408","443","313","56","1360","1220","140","951","269","1360","34453","47","097","47097","2010"
"Census Tract 505.03, Lauderdale County, Tennessee","126","349","226","72","951","773","178","649","124","951","50175","47","097","47097","2010"
"Census Tract 505.04, Lauderdale County, Tennessee","537","452","141","5","1398","1135","263","610","525","1398","28672","47","097","47097","2010"
"Census Tract 505.05, Lauderdale County, Tennessee","595","535","191","10","1799","1331","468","595","736","1799","22025","47","097","47097","2010"
"Census Tract 505.06, Lauderdale County, Tennessee","175","299","260","51","870","785","85","624","161","870","36552","47","097","47097","2010"
"Census Tract 506, Lauderdale County, Tennessee","350","418","221","37","1202","1026","176","670","356","1202","30674","47","097","47097","2010"
"Census Tract 9601, Lawrence County, Tennessee","574","234","512","37","1675","1357","318","1124","233","1675","36195","47","099","47099","2010"
"Census Tract 9602, Lawrence County, Tennessee","228","391","282","55","1092","956","136","800","156","1092","35667","47","099","47099","2010"
"Census Tract 9603, Lawrence County, Tennessee","523","516","449","108","1871","1596","275","1276","320","1871","37781","47","099","47099","2010"
"Census Tract 9604.01, Lawrence County, Tennessee","1008","892","460","74","2676","2434","242","1673","761","2676","31719","47","099","47099","2010"
"Census Tract 9604.02, Lawrence County, Tennessee","531","442","495","64","1644","1532","112","1167","365","1644","37753","47","099","47099","2010"
"Census Tract 9605.01, Lawrence County, Tennessee","783","510","342","72","1991","1707","284","1112","595","1991","27975","47","099","47099","2010"
"Census Tract 9605.02, Lawrence County, Tennessee","579","673","440","35","2007","1727","280","1374","353","2007","36104","47","099","47099","2010"
"Census Tract 9606, Lawrence County, Tennessee","353","289","231","12","1167","885","282","760","125","1167","30256","47","099","47099","2010"
"Census Tract 9607, Lawrence County, Tennessee","491","440","476","74","1681","1481","200","1202","279","1681","42995","47","099","47099","2010"
"Census Tract 9608, Lawrence County, Tennessee","449","511","305","93","1417","1358","59","1211","147","1417","35071","47","099","47099","2010"
"Census Tract 9609, Lawrence County, Tennessee","249","221","248","35","794","753","41","594","159","794","43343","47","099","47099","2010"
"Census Tract 9701, Lewis County, Tennessee","509","577","500","42","2053","1628","425","1394","234","2053","41341","47","101","47101","2010"
"Census Tract 9702, Lewis County, Tennessee","1218","973","653","74","3333","2918","415","2177","741","3333","31047","47","101","47101","2010"
"Census Tract 9750, Lincoln County, Tennessee","148","253","218","12","683","631","52","545","86","683","45417","47","103","47103","2010"
"Census Tract 9751, Lincoln County, Tennessee","249","356","264","61","1069","930","139","775","155","1069","48526","47","103","47103","2010"
"Census Tract 9752, Lincoln County, Tennessee","300","292","256","42","967","890","77","851","39","967","46058","47","103","47103","2010"
"Census Tract 9753, Lincoln County, Tennessee","957","1001","715","12","3147","2685","462","1674","1011","3147","33301","47","103","47103","2010"
"Census Tract 9754, Lincoln County, Tennessee","559","570","349","83","1817","1561","256","1155","406","1817","36463","47","103","47103","2010"
"Census Tract 9755, Lincoln County, Tennessee","621","655","689","30","2283","1995","288","1576","419","2283","36279","47","103","47103","2010"
"Census Tract 9756.01, Lincoln County, Tennessee","424","767","528","65","1924","1784","140","1300","484","1924","48833","47","103","47103","2010"
"Census Tract 9756.02, Lincoln County, Tennessee","599","528","398","86","1772","1611","161","1268","343","1772","47396","47","103","47103","2010"
"Census Tract 9757, Lincoln County, Tennessee","404","459","479","23","1424","1365","59","1108","257","1424","44886","47","103","47103","2010"
"Census Tract 601, Loudon County, Tennessee","602","644","585","89","1992","1920","72","1550","370","1992","51500","47","105","47105","2010"
"Census Tract 602.01, Loudon County, Tennessee","413","510","301","152","1459","1376","83","1196","180","1459","45878","47","105","47105","2010"
"Census Tract 602.02, Loudon County, Tennessee","1235","1000","562","283","3389","3080","309","1509","1571","3389","26781","47","105","47105","2010"
"Census Tract 603.01, Loudon County, Tennessee","344","460","375","134","1380","1313","67","1073","240","1380","46125","47","105","47105","2010"
"Census Tract 603.02, Loudon County, Tennessee","646","907","758","188","2570","2499","71","2271","228","2570","76766","47","105","47105","2010"
"Census Tract 604, Loudon County, Tennessee","616","665","446","135","2090","1862","228","1553","309","2090","47927","47","105","47105","2010"
"Census Tract 605.01, Loudon County, Tennessee","2361","944","480","106","4329","3891","438","3496","395","4329","66292","47","105","47105","2010"
"Census Tract 605.02, Loudon County, Tennessee","160","337","302","27","851","826","25","607","219","851","41741","47","105","47105","2010"
"Census Tract 606, Loudon County, Tennessee","510","598","459","114","1842","1681","161","1156","525","1842","38686","47","105","47105","2010"
"Census Tract 607, Loudon County, Tennessee","271","430","259","33","1118","993","125","738","255","1118","37302","47","105","47105","2010"
"Census Tract 9701.01, McMinn County, Tennessee","856","840","715","43","2652","2454","198","1921","533","2652","43061","47","107","47107","2010"
"Census Tract 9701.02, McMinn County, Tennessee","558","641","570","37","2062","1806","256","1585","221","2062","50772","47","107","47107","2010"
"Census Tract 9702, McMinn County, Tennessee","1272","789","597","50","3101","2708","393","1320","1388","3101","25893","47","107","47107","2010"
"Census Tract 9703, McMinn County, Tennessee","401","492","221","26","1313","1140","173","696","444","1313","28986","47","107","47107","2010"
"Census Tract 9704.01, McMinn County, Tennessee","440","387","434","23","1492","1284","208","1071","213","1492","45000","47","107","47107","2010"
"Census Tract 9704.02, McMinn County, Tennessee","616","1077","353","119","2330","2165","165","1796","369","2330","39538","47","107","47107","2010"
"Census Tract 9705, McMinn County, Tennessee","614","657","328","119","1882","1718","164","1241","477","1882","30240","47","107","47107","2010"
"Census Tract 9706, McMinn County, Tennessee","993","1041","710","183","3186","2927","259","2194","733","3186","36945","47","107","47107","2010"
"Census Tract 9707, McMinn County, Tennessee","711","550","418","97","2080","1776","304","1500","276","2080","38715","47","107","47107","2010"
"Census Tract 9708, McMinn County, Tennessee","798","1031","853","150","3092","2832","260","2335","497","3092","46811","47","107","47107","2010"
"Census Tract 9301, McNairy County, Tennessee","554","682","366","39","1989","1641","348","1278","363","1989","35382","47","109","47109","2010"
"Census Tract 9302, McNairy County, Tennessee","255","261","253","37","915","806","109","666","140","915","33214","47","109","47109","2010"
"Census Tract 9303, McNairy County, Tennessee","389","370","248","54","1310","1061","249","861","200","1310","32357","47","109","47109","2010"
"Census Tract 9304, McNairy County, Tennessee","342","247","150","25","872","764","108","512","252","872","34219","47","109","47109","2010"
"Census Tract 9305, McNairy County, Tennessee","1346","1040","638","106","3698","3130","568","2311","819","3698","31301","47","109","47109","2010"
"Census Tract 9306, McNairy County, Tennessee","503","528","350","53","1609","1434","175","1166","268","1609","37778","47","109","47109","2010"
"Census Tract 9307, McNairy County, Tennessee","535","450","263","29","1493","1277","216","978","299","1493","36108","47","109","47109","2010"
"Census Tract 9701, Macon County, Tennessee","555","723","535","48","2299","1861","438","1371","490","2299","35547","47","111","47111","2010"
"Census Tract 9702, Macon County, Tennessee","562","667","719","41","2296","1989","307","1668","321","2296","33197","47","111","47111","2010"
"Census Tract 9703, Macon County, Tennessee","1138","1048","662","53","3409","2901","508","1961","940","3409","31169","47","111","47111","2010"
"Census Tract 9704, Macon County, Tennessee","441","609","352","51","1739","1453","286","1187","266","1739","34241","47","111","47111","2010"
"Census Tract 1, Madison County, Tennessee","386","522","395","102","1555","1405","150","1063","342","1555","42702","47","113","47113","2010"
"Census Tract 2, Madison County, Tennessee","984","1143","415","68","3021","2610","411","1071","1539","3021","31667","47","113","47113","2010"
"Census Tract 3, Madison County, Tennessee","802","783","395","34","2169","2014","155","988","1026","2169","30630","47","113","47113","2010"
"Census Tract 4, Madison County, Tennessee","483","518","258","129","1593","1388","205","711","677","1593","26023","47","113","47113","2010"
"Census Tract 5, Madison County, Tennessee","732","598","50","49","1774","1429","345","495","934","1774","14221","47","113","47113","2010"
"Census Tract 6, Madison County, Tennessee","206","443","262","35","1169","946","223","617","329","1169","35036","47","113","47113","2010"
"Census Tract 7, Madison County, Tennessee","330","485","102","34","1388","951","437","349","602","1388","25354","47","113","47113","2010"
"Census Tract 8, Madison County, Tennessee","412","136","18","0","860","566","294","118","448","860","9464","47","113","47113","2010"
"Census Tract 9, Madison County, Tennessee","356","500","97","18","1210","971","239","395","576","1210","16276","47","113","47113","2010"
"Census Tract 10, Madison County, Tennessee","411","319","149","17","1002","896","106","456","440","1002","19304","47","113","47113","2010"
"Census Tract 11, Madison County, Tennessee","218","161","28","0","407","407","0","168","239","407","12639","47","113","47113","2010"
"Census Tract 13, Madison County, Tennessee","715","1098","620","85","2856","2518","338","1813","705","2856","33611","47","113","47113","2010"
"Census Tract 14.01, Madison County, Tennessee","231","280","188","60","843","759","84","589","170","843","40391","47","113","47113","2010"
"Census Tract 14.02, Madison County, Tennessee","274","355","169","56","907","854","53","654","200","907","39924","47","113","47113","2010"
"Census Tract 15.01, Madison County, Tennessee","307","745","577","82","1760","1711","49","1516","195","1760","49080","47","113","47113","2010"
"Census Tract 15.02, Madison County, Tennessee","475","787","727","137","2367","2126","241","1892","234","2367","56302","47","113","47113","2010"
"Census Tract 16.03, Madison County, Tennessee","233","390","340","30","1056","993","63","842","151","1056","53773","47","113","47113","2010"
"Census Tract 16.04, Madison County, Tennessee","339","356","399","42","1136","1136","0","1024","112","1136","76635","47","113","47113","2010"
"Census Tract 16.05, Madison County, Tennessee","159","518","137","32","965","846","119","280","566","965","43378","47","113","47113","2010"
"Census Tract 16.06, Madison County, Tennessee","752","1529","1256","157","4241","3694","547","2167","1527","4241","49869","47","113","47113","2010"
"Census Tract 16.07, Madison County, Tennessee","315","966","778","154","2304","2213","91","1932","281","2304","59841","47","113","47113","2010"
"Census Tract 16.08, Madison County, Tennessee","186","270","323","43","913","822","91","714","108","913","59375","47","113","47113","2010"
"Census Tract 16.09, Madison County, Tennessee","117","263","183","47","727","610","117","557","53","727","81094","47","113","47113","2010"
"Census Tract 16.10, Madison County, Tennessee","179","590","609","148","1585","1526","59","1442","84","1585","124043","47","113","47113","2010"
"Census Tract 17, Madison County, Tennessee","210","261","174","56","701","701","0","537","164","701","37486","47","113","47113","2010"
"Census Tract 18, Madison County, Tennessee","419","439","376","93","1413","1327","86","1036","291","1413","38125","47","113","47113","2010"
"Census Tract 19, Madison County, Tennessee","481","650","408","62","1749","1601","148","1406","195","1749","46373","47","113","47113","2010"
"Census Tract 501.01, Marion County, Tennessee","633","574","333","23","1767","1563","204","1258","305","1767","34844","47","115","47115","2010"
"Census Tract 501.02, Marion County, Tennessee","995","766","615","116","2737","2492","245","2070","422","2737","37973","47","115","47115","2010"
"Census Tract 502.01, Marion County, Tennessee","522","653","563","86","2021","1824","197","1360","464","2021","48616","47","115","47115","2010"
"Census Tract 502.02, Marion County, Tennessee","810","835","417","84","2482","2146","336","1488","658","2482","37435","47","115","47115","2010"
"Census Tract 503.01, Marion County, Tennessee","776","788","394","156","2518","2114","404","1585","529","2518","34931","47","115","47115","2010"
"Census Tract 503.02, Marion County, Tennessee","379","412","366","9","1447","1166","281","945","221","1447","38158","47","115","47115","2010"
"Census Tract 9550, Marshall County, Tennessee","444","929","905","98","2549","2376","173","2071","305","2549","58229","47","117","47117","2010"
"Census Tract 9551, Marshall County, Tennessee","458","850","645","113","2279","2066","213","1794","272","2279","45938","47","117","47117","2010"
"Census Tract 9552, Marshall County, Tennessee","583","923","535","90","2491","2131","360","1582","549","2491","37953","47","117","47117","2010"
"Census Tract 9553, Marshall County, Tennessee","733","591","302","78","1856","1704","152","680","1024","1856","20584","47","117","47117","2010"
"Census Tract 9554, Marshall County, Tennessee","449","757","373","68","1801","1647","154","1150","497","1801","36972","47","117","47117","2010"
"Census Tract 9555, Marshall County, Tennessee","430","853","375","125","1945","1783","162","1464","319","1945","37532","47","117","47117","2010"
"Census Tract 101, Maury County, Tennessee","360","579","378","45","1504","1362","142","1095","267","1504","44025","47","119","47119","2010"
"Census Tract 102.01, Maury County, Tennessee","607","699","842","157","2371","2305","66","1755","550","2371","52558","47","119","47119","2010"
"Census Tract 102.02, Maury County, Tennessee","401","1016","959","85","2611","2461","150","1982","479","2611","54614","47","119","47119","2010"
"Census Tract 103.01, Maury County, Tennessee","390","780","789","143","2202","2102","100","1882","220","2202","61573","47","119","47119","2010"
"Census Tract 103.02, Maury County, Tennessee","164","285","435","86","1052","970","82","940","30","1052","68900","47","119","47119","2010"
"Census Tract 104, Maury County, Tennessee","723","1081","719","121","2824","2644","180","1567","1077","2824","45225","47","119","47119","2010"
"Census Tract 105, Maury County, Tennessee","636","751","404","64","2259","1855","404","1020","835","2259","25154","47","119","47119","2010"
"Census Tract 106, Maury County, Tennessee","610","1014","360","142","2402","2126","276","1026","1100","2402","30448","47","119","47119","2010"
"Census Tract 107, Maury County, Tennessee","847","586","558","59","2196","2050","146","1082","968","2196","28484","47","119","47119","2010"
"Census Tract 108.01, Maury County, Tennessee","234","724","328","27","1387","1313","74","1135","178","1387","52813","47","119","47119","2010"
"Census Tract 108.02, Maury County, Tennessee","648","966","510","212","2642","2336","306","1585","751","2642","47153","47","119","47119","2010"
"Census Tract 109, Maury County, Tennessee","356","505","420","58","1532","1339","193","1134","205","1532","50295","47","119","47119","2010"
"Census Tract 110.01, Maury County, Tennessee","274","358","348","99","1119","1079","40","921","158","1119","51161","47","119","47119","2010"
"Census Tract 110.02, Maury County, Tennessee","922","1098","502","110","2999","2632","367","1751","881","2999","32422","47","119","47119","2010"
"Census Tract 111.01, Maury County, Tennessee","521","751","487","61","1919","1820","99","1527","293","1919","63698","47","119","47119","2010"
"Census Tract 111.02, Maury County, Tennessee","270","459","367","81","1242","1177","65","694","483","1242","45758","47","119","47119","2010"
"Census Tract 112, Maury County, Tennessee","400","899","786","89","2380","2174","206","1970","204","2380","58006","47","119","47119","2010"
"Census Tract 9601, Meigs County, Tennessee","565","586","328","34","1924","1513","411","1065","448","1924","33598","47","121","47121","2010"
"Census Tract 9602, Meigs County, Tennessee","589","625","413","85","1899","1712","187","1288","424","1899","38646","47","121","47121","2010"
"Census Tract 9603, Meigs County, Tennessee","592","468","202","71","1742","1333","409","1092","241","1742","31712","47","121","47121","2010"
"Census Tract 9250, Monroe County, Tennessee","1163","1132","681","49","3478","3025","453","2434","591","3478","38368","47","123","47123","2010"
"Census Tract 9251, Monroe County, Tennessee","1043","1017","678","230","3403","2968","435","2197","771","3403","36896","47","123","47123","2010"
"Census Tract 9252, Monroe County, Tennessee","740","739","411","40","2108","1930","178","1144","786","2108","28438","47","123","47123","2010"
"Census Tract 9253, Monroe County, Tennessee","935","1221","805","110","3368","3071","297","2188","883","3368","39123","47","123","47123","2010"
"Census Tract 9254, Monroe County, Tennessee","1040","1157","866","82","3522","3145","377","2231","914","3522","36558","47","123","47123","2010"
"Census Tract 9255.01, Monroe County, Tennessee","428","404","182","59","1528","1073","455","794","279","1528","22675","47","123","47123","2010"
"Census Tract 9255.02, Monroe County, Tennessee","909","878","478","69","2923","2334","589","2090","244","2923","35742","47","123","47123","2010"
"Census Tract 1001, Montgomery County, Tennessee","160","104","44","36","518","344","174","29","315","518","20741","47","125","47125","2010"
"Census Tract 1002, Montgomery County, Tennessee","257","335","196","62","996","850","146","327","523","996","27981","47","125","47125","2010"
"Census Tract 1003, Montgomery County, Tennessee","629","741","564","68","2304","2002","302","1031","971","2304","43176","47","125","47125","2010"
"Census Tract 1004, Montgomery County, Tennessee","453","491","187","14","1426","1145","281","503","642","1426","21212","47","125","47125","2010"
"Census Tract 1005, Montgomery County, Tennessee","608","1108","382","124","2467","2222","245","711","1511","2467","33905","47","125","47125","2010"
"Census Tract 1006.01, Montgomery County, Tennessee","443","216","235","37","1044","931","113","773","158","1044","54550","47","125","47125","2010"
"Census Tract 1006.02, Montgomery County, Tennessee","486","638","305","19","1514","1448","66","708","740","1514","47193","47","125","47125","2010"
"Census Tract 1007, Montgomery County, Tennessee","106","287","113","0","637","506","131","265","241","637","58000","47","125","47125","2010"
"Census Tract 1008, Montgomery County, Tennessee","302","343","141","0","890","786","104","206","580","890","16944","47","125","47125","2010"
"Census Tract 1009, Montgomery County, Tennessee","348","570","145","68","1591","1131","460","328","803","1591","28603","47","125","47125","2010"
"Census Tract 1010.01, Montgomery County, Tennessee","416","783","501","60","1919","1760","159","971","789","1919","40714","47","125","47125","2010"
"Census Tract 1010.02, Montgomery County, Tennessee","162","477","408","46","1349","1093","256","874","219","1349","52114","47","125","47125","2010"
"Census Tract 1011.01, Montgomery County, Tennessee","157","519","313","41","1101","1030","71","663","367","1101","42100","47","125","47125","2010"
"Census Tract 1011.02, Montgomery County, Tennessee","539","1394","622","88","3038","2643","395","1606","1037","3038","40214","47","125","47125","2010"
"Census Tract 1011.03, Montgomery County, Tennessee","218","323","287","65","893","893","0","744","149","893","46115","47","125","47125","2010"
"Census Tract 1012.01, Montgomery County, Tennessee","157","363","195","67","890","782","108","335","447","890","47875","47","125","47125","2010"
"Census Tract 1012.02, Montgomery County, Tennessee","296","745","376","46","1596","1463","133","773","690","1596","34921","47","125","47125","2010"
"Census Tract 1013.03, Montgomery County, Tennessee","343","862","952","148","2528","2305","223","1331","974","2528","50698","47","125","47125","2010"
"Census Tract 1013.04, Montgomery County, Tennessee","442","1007","393","52","2323","1894","429","944","950","2323","39455","47","125","47125","2010"
"Census Tract 1013.05, Montgomery County, Tennessee","56","544","329","27","1121","956","165","615","341","1121","45708","47","125","47125","2010"
"Census Tract 1013.06, Montgomery County, Tennessee","182","869","469","130","1889","1650","239","1128","522","1889","49423","47","125","47125","2010"
"Census Tract 1013.07, Montgomery County, Tennessee","145","459","189","55","1021","848","173","433","415","1021","45431","47","125","47125","2010"
"Census Tract 1014, Montgomery County, Tennessee","154","747","371","9","1521","1281","240","20","1261","1521","49297","47","125","47125","2010"
"Census Tract 1015, Montgomery County, Tennessee","576","1349","718","134","3078","2777","301","2317","460","3078","56203","47","125","47125","2010"
"Census Tract 1016, Montgomery County, Tennessee","698","708","571","134","2230","2111","119","1506","605","2230","38483","47","125","47125","2010"
"Census Tract 1017, Montgomery County, Tennessee","901","672","1041","153","3102","2767","335","2579","188","3102","51481","47","125","47125","2010"
"Census Tract 1018.02, Montgomery County, Tennessee","696","1595","1343","149","3825","3783","42","3588","195","3825","66211","47","125","47125","2010"
"Census Tract 1018.03, Montgomery County, Tennessee","366","964","782","135","2370","2247","123","1648","599","2370","71156","47","125","47125","2010"
"Census Tract 1018.04, Montgomery County, Tennessee","329","675","912","130","2092","2046","46","1895","151","2092","84906","47","125","47125","2010"
"Census Tract 1019.02, Montgomery County, Tennessee","186","310","361","78","964","935","29","771","164","964","67299","47","125","47125","2010"
"Census Tract 1019.03, Montgomery County, Tennessee","511","1286","879","98","3153","2774","379","1842","932","3153","47143","47","125","47125","2010"
"Census Tract 1019.04, Montgomery County, Tennessee","117","172","319","20","637","628","9","552","76","637","94239","47","125","47125","2010"
"Census Tract 1020.01, Montgomery County, Tennessee","404","801","430","65","1774","1700","74","1398","302","1774","49758","47","125","47125","2010"
"Census Tract 1020.02, Montgomery County, Tennessee","359","961","724","100","2435","2144","291","1753","391","2435","56651","47","125","47125","2010"
"Census Tract 1020.03, Montgomery County, Tennessee","251","688","553","68","1738","1560","178","987","573","1738","58401","47","125","47125","2010"
"Census Tract 1020.04, Montgomery County, Tennessee","94","811","484","51","1639","1440","199","882","558","1639","64142","47","125","47125","2010"
"Census Tract 1020.05, Montgomery County, Tennessee","226","848","532","72","1938","1678","260","852","826","1938","50485","47","125","47125","2010"
"Census Tract 1020.06, Montgomery County, Tennessee","289","850","691","29","1960","1859","101","1420","439","1960","56338","47","125","47125","2010"
"Census Tract 9801, Montgomery County, Tennessee","0","0","0","0","0","0","0","0","0","0","-666666666","47","125","47125","2010"
"Census Tract 9301, Moore County, Tennessee","306","474","463","91","1695","1334","361","1202","132","1695","53025","47","127","47127","2010"
"Census Tract 9302, Moore County, Tennessee","325","398","314","25","1172","1062","110","725","337","1172","38281","47","127","47127","2010"
"Census Tract 1101, Morgan County, Tennessee","578","440","261","37","1585","1316","269","1111","205","1585","32621","47","129","47129","2010"
"Census Tract 1102, Morgan County, Tennessee","591","522","298","87","1591","1498","93","1327","171","1591","28664","47","129","47129","2010"
"Census Tract 1103, Morgan County, Tennessee","388","539","505","49","1613","1481","132","960","521","1613","39864","47","129","47129","2010"
"Census Tract 1104, Morgan County, Tennessee","554","759","409","79","1909","1801","108","1433","368","1909","42942","47","129","47129","2010"
"Census Tract 1105, Morgan County, Tennessee","552","687","529","90","2061","1858","203","1678","180","2061","42149","47","129","47129","2010"
"Census Tract 9650, Obion County, Tennessee","612","662","381","27","2004","1682","322","1196","486","2004","36629","47","131","47131","2010"
"Census Tract 9651, Obion County, Tennessee","209","402","390","22","1084","1023","61","855","168","1084","50417","47","131","47131","2010"
"Census Tract 9652, Obion County, Tennessee","183","292","221","87","971","783","188","689","94","971","51025","47","131","47131","2010"
"Census Tract 9653, Obion County, Tennessee","548","548","360","62","1807","1518","289","1309","209","1807","43651","47","131","47131","2010"
"Census Tract 9654, Obion County, Tennessee","615","550","435","131","1932","1731","201","1290","441","1932","39967","47","131","47131","2010"
"Census Tract 9655, Obion County, Tennessee","378","403","250","14","1211","1045","166","555","490","1211","31841","47","131","47131","2010"
"Census Tract 9656, Obion County, Tennessee","689","526","423","14","2012","1652","360","778","874","2012","26689","47","131","47131","2010"
"Census Tract 9657, Obion County, Tennessee","542","819","451","124","2213","1936","277","1106","830","2213","40455","47","131","47131","2010"
"Census Tract 9658, Obion County, Tennessee","145","247","279","33","807","704","103","600","104","807","57500","47","131","47131","2010"
"Census Tract 9659, Obion County, Tennessee","232","179","177","0","668","588","80","444","144","668","32500","47","131","47131","2010"
"Census Tract 9501, Overton County, Tennessee","160","286","160","6","870","612","258","531","81","870","34674","47","133","47133","2010"
"Census Tract 9502, Overton County, Tennessee","317","179","234","0","857","730","127","593","137","857","33962","47","133","47133","2010"
"Census Tract 9503.01, Overton County, Tennessee","608","589","486","115","2195","1798","397","1418","380","2195","41282","47","133","47133","2010"
"Census Tract 9503.02, Overton County, Tennessee","450","482","324","74","1431","1330","101","1031","299","1431","36968","47","133","47133","2010"
"Census Tract 9504, Overton County, Tennessee","352","334","194","22","1012","902","110","775","127","1012","26299","47","133","47133","2010"
"Census Tract 9505, Overton County, Tennessee","734","925","699","110","2619","2468","151","2038","430","2619","33950","47","133","47133","2010"
"Census Tract 9506, Overton County, Tennessee","317","353","299","21","1182","990","192","716","274","1182","30000","47","133","47133","2010"
"Census Tract 9301, Perry County, Tennessee","479","504","232","91","1995","1306","689","1007","299","1995","32108","47","135","47135","2010"
"Census Tract 9302, Perry County, Tennessee","817","807","299","64","2548","1987","561","1508","479","2548","31435","47","135","47135","2010"
"Census Tract 9251, Pickett County, Tennessee","715","742","595","122","3059","2174","885","1655","519","3059","30193","47","137","47137","2010"
"Census Tract 9501, Polk County, Tennessee","233","191","94","23","751","541","210","482","59","751","26202","47","139","47139","2010"
"Census Tract 9502.01, Polk County, Tennessee","339","284","117","14","1041","754","287","633","121","1041","41014","47","139","47139","2010"
"Census Tract 9502.02, Polk County, Tennessee","817","716","544","117","2662","2194","468","1703","491","2662","35956","47","139","47139","2010"
"Census Tract 9503, Polk County, Tennessee","496","443","359","83","1658","1381","277","1109","272","1658","34505","47","139","47139","2010"
"Census Tract 9504, Polk County, Tennessee","593","461","328","59","1784","1441","343","1167","274","1784","31115","47","139","47139","2010"
"Census Tract 1, Putnam County, Tennessee","748","839","541","37","2451","2165","286","1273","892","2451","27636","47","141","47141","2010"
"Census Tract 2, Putnam County, Tennessee","1116","1285","844","100","3770","3345","425","2397","948","3770","35175","47","141","47141","2010"
"Census Tract 3.01, Putnam County, Tennessee","274","315","310","83","1120","982","138","853","129","1120","41023","47","141","47141","2010"
"Census Tract 3.02, Putnam County, Tennessee","976","1035","773","131","3239","2915","324","869","2046","3239","21391","47","141","47141","2010"
"Census Tract 3.03, Putnam County, Tennessee","239","335","227","62","997","863","134","664","199","997","40755","47","141","47141","2010"
"Census Tract 4, Putnam County, Tennessee","540","698","413","70","1922","1721","201","1013","708","1922","46915","47","141","47141","2010"
"Census Tract 5, Putnam County, Tennessee","271","378","215","8","1081","872","209","413","459","1081","43431","47","141","47141","2010"
"Census Tract 6, Putnam County, Tennessee","497","500","354","28","1461","1379","82","922","457","1461","49504","47","141","47141","2010"
"Census Tract 7, Putnam County, Tennessee","576","518","284","15","1621","1393","228","396","997","1621","19120","47","141","47141","2010"
"Census Tract 8, Putnam County, Tennessee","546","680","373","0","1903","1599","304","348","1251","1903","18257","47","141","47141","2010"
"Census Tract 9, Putnam County, Tennessee","632","848","610","144","2622","2234","388","1813","421","2622","41569","47","141","47141","2010"
"Census Tract 10, Putnam County, Tennessee","484","456","341","44","1587","1325","262","1102","223","1587","38586","47","141","47141","2010"
"Census Tract 11, Putnam County, Tennessee","969","1057","427","77","2727","2530","197","2092","438","2727","31803","47","141","47141","2010"
"Census Tract 12, Putnam County, Tennessee","947","1232","950","180","3602","3309","293","2655","654","3602","46491","47","141","47141","2010"
"Census Tract 13, Putnam County, Tennessee","193","292","400","43","972","928","44","852","76","972","53519","47","141","47141","2010"
"Census Tract 9750, Rhea County, Tennessee","916","704","435","75","2969","2130","839","1694","436","2969","35067","47","143","47143","2010"
"Census Tract 9707.01, Cumberland County, Tennessee","470","294","103","17","1318","884","434","806","78","1318","33900","47","035","47035","2010"
"Census Tract 9707.02, Cumberland County, Tennessee","621","452","580","100","2185","1753","432","1493","260","2185","34321","47","035","47035","2010"
"Census Tract 9708, Cumberland County, Tennessee","572","439","525","70","1921","1606","315","1359","247","1921","36076","47","035","47035","2010"
"Census Tract 101.03, Davidson County, Tennessee","198","371","208","34","961","811","150","663","148","961","81027","47","037","47037","2010"
"Census Tract 101.04, Davidson County, Tennessee","310","664","337","64","1440","1375","65","1182","193","1440","45625","47","037","47037","2010"
"Census Tract 101.05, Davidson County, Tennessee","342","720","556","25","1752","1643","109","1315","328","1752","54421","47","037","47037","2010"
"Census Tract 101.06, Davidson County, Tennessee","84","575","200","17","950","876","74","722","154","950","44664","47","037","47037","2010"
"Census Tract 102.01, Davidson County, Tennessee","284","815","549","16","1764","1664","100","1271","393","1764","55132","47","037","47037","2010"
"Census Tract 102.02, Davidson County, Tennessee","524","502","542","12","1600","1580","20","1400","180","1600","58750","47","037","47037","2010"
"Census Tract 103.01, Davidson County, Tennessee","343","640","452","42","1582","1477","105","914","563","1582","47976","47","037","47037","2010"
"Census Tract 103.02, Davidson County, Tennessee","178","361","251","35","932","825","107","348","477","932","36725","47","037","47037","2010"
"Census Tract 103.03, Davidson County, Tennessee","325","916","519","90","2032","1850","182","809","1041","2032","46807","47","037","47037","2010"
"Census Tract 104.01, Davidson County, Tennessee","453","856","449","89","2038","1847","191","892","955","2038","39288","47","037","47037","2010"
"Census Tract 104.02, Davidson County, Tennessee","901","799","475","146","2563","2321","242","827","1494","2563","29160","47","037","47037","2010"
"Census Tract 105.01, Davidson County, Tennessee","781","945","535","63","2526","2324","202","1658","666","2526","34764","47","037","47037","2010"
"Census Tract 105.02, Davidson County, Tennessee","356","663","654","86","1968","1759","209","1330","429","1968","52131","47","037","47037","2010"
"Census Tract 106.01, Davidson County, Tennessee","597","670","590","51","2199","1908","291","1120","788","2199","41889","47","037","47037","2010"
"Census Tract 106.02, Davidson County, Tennessee","310","495","360","48","1368","1213","155","796","417","1368","36250","47","037","47037","2010"
"Census Tract 107.01, Davidson County, Tennessee","351","982","388","83","2075","1804","271","917","887","2075","35967","47","037","47037","2010"
"Census Tract 107.02, Davidson County, Tennessee","698","553","192","135","1938","1578","360","324","1254","1938","25954","47","037","47037","2010"
"Census Tract 108.01, Davidson County, Tennessee","504","1308","487","139","2558","2438","120","1167","1271","2558","39516","47","037","47037","2010"
"Census Tract 108.02, Davidson County, Tennessee","511","705","253","33","1606","1502","104","1100","402","1606","44038","47","037","47037","2010"
"Census Tract 109.01, Davidson County, Tennessee","319","550","356","34","1428","1259","169","744","515","1428","41116","47","037","47037","2010"
"Census Tract 109.03, Davidson County, Tennessee","287","922","441","92","1972","1742","230","908","834","1972","33801","47","037","47037","2010"
"Census Tract 109.04, Davidson County, Tennessee","394","458","270","34","1244","1156","88","556","600","1244","28688","47","037","47037","2010"
"Census Tract 110.01, Davidson County, Tennessee","589","1021","435","84","2444","2129","315","1133","996","2444","27182","47","037","47037","2010"
"Census Tract 110.02, Davidson County, Tennessee","213","626","305","25","1270","1169","101","671","498","1270","41523","47","037","47037","2010"
"Census Tract 111, Davidson County, Tennessee","385","593","610","127","1932","1715","217","1271","444","1932","53625","47","037","47037","2010"
"Census Tract 112, Davidson County, Tennessee","292","886","627","24","2003","1829","174","1405","424","2003","45368","47","037","47037","2010"
"Census Tract 113, Davidson County, Tennessee","648","771","404","29","2193","1852","341","1073","779","2193","23352","47","037","47037","2010"
"Census Tract 114, Davidson County, Tennessee","577","1016","337","152","2383","2082","301","1020","1062","2383","26914","47","037","47037","2010"
"Census Tract 115, Davidson County, Tennessee","397","624","611","46","1843","1678","165","1291","387","1843","49018","47","037","47037","2010"
"Census Tract 116, Davidson County, Tennessee","586","817","666","168","2306","2237","69","1660","577","2306","44982","47","037","47037","2010"
"Census Tract 117, Davidson County, Tennessee","540","945","504","85","2517","2074","443","1143","931","2517","36533","47","037","47037","2010"
"Census Tract 118, Davidson County, Tennessee","315","416","183","0","1108","914","194","257","657","1108","18600","47","037","47037","2010"
"Census Tract 119, Davidson County, Tennessee","133","384","100","13","850","630","220","279","351","850","28804","47","037","47037","2010"
"Census Tract 121, Davidson County, Tennessee","240","598","353","43","1284","1234","50","720","514","1284","52372","47","037","47037","2010"
"Census Tract 122, Davidson County, Tennessee","187","556","350","47","1161","1140","21","775","365","1161","46000","47","037","47037","2010"
"Census Tract 126, Davidson County, Tennessee","233","346","117","0","871","696","175","214","482","871","21111","47","037","47037","2010"
"Census Tract 127.01, Davidson County, Tennessee","689","971","304","72","2218","2036","182","1212","824","2218","28935","47","037","47037","2010"
"Census Tract 127.02, Davidson County, Tennessee","247","326","235","50","1051","858","193","694","164","1051","43318","47","037","47037","2010"
"Census Tract 128.01, Davidson County, Tennessee","643","919","411","91","2318","2064","254","1385","679","2318","38712","47","037","47037","2010"
"Census Tract 128.02, Davidson County, Tennessee","262","542","212","70","1257","1086","171","808","278","1257","43333","47","037","47037","2010"
"Census Tract 130, Davidson County, Tennessee","0","0","0","0","0","0","0","0","0","0","-666666666","47","037","47037","2010"
"Census Tract 131, Davidson County, Tennessee","219","258","269","97","922","843","79","667","176","922","55764","47","037","47037","2010"
"Census Tract 132.01, Davidson County, Tennessee","255","576","345","85","1375","1261","114","860","401","1375","47259","47","037","47037","2010"
"Census Tract 132.02, Davidson County, Tennessee","319","624","250","25","1392","1218","174","778","440","1392","39409","47","037","47037","2010"
"Census Tract 133, Davidson County, Tennessee","390","636","461","69","1762","1556","206","791","765","1762","35369","47","037","47037","2010"
"Census Tract 134, Davidson County, Tennessee","323","919","515","23","2084","1780","304","1207","573","2084","54462","47","037","47037","2010"
"Census Tract 135, Davidson County, Tennessee","244","550","136","29","1108","959","149","453","506","1108","33625","47","037","47037","2010"
"Census Tract 136.01, Davidson County, Tennessee","531","567","106","17","1382","1221","161","287","934","1382","18029","47","037","47037","2010"
"Census Tract 136.02, Davidson County, Tennessee","230","40","0","0","313","270","43","10","260","313","11111","47","037","47037","2010"
"Census Tract 137, Davidson County, Tennessee","901","949","347","61","2640","2258","382","646","1612","2640","24026","47","037","47037","2010"
"Census Tract 138, Davidson County, Tennessee","283","334","75","18","830","710","120","387","323","830","16413","47","037","47037","2010"
"Census Tract 139, Davidson County, Tennessee","297","380","15","0","853","692","161","271","421","853","21964","47","037","47037","2010"
"Census Tract 142, Davidson County, Tennessee","476","369","75","17","1102","937","165","111","826","1102","14968","47","037","47037","2010"
"Census Tract 143, Davidson County, Tennessee","341","276","195","0","1003","812","191","337","475","1003","24333","47","037","47037","2010"
"Census Tract 144, Davidson County, Tennessee","106","163","26","0","421","295","126","0","295","421","19219","47","037","47037","2010"
"Census Tract 148, Davidson County, Tennessee","549","370","8","17","1120","944","176","23","921","1120","8911","47","037","47037","2010"
"Census Tract 151, Davidson County, Tennessee","510","629","594","85","1916","1818","98","1291","527","1916","42935","47","037","47037","2010"
"Census Tract 152, Davidson County, Tennessee","309","524","327","23","1238","1183","55","886","297","1238","47813","47","037","47037","2010"
"Census Tract 153, Davidson County, Tennessee","678","1112","709","67","2701","2566","135","2256","310","2701","53590","47","037","47037","2010"
"Census Tract 154.01, Davidson County, Tennessee","561","889","868","61","2489","2379","110","1894","485","2489","67321","47","037","47037","2010"
"Census Tract 154.02, Davidson County, Tennessee","370","685","519","104","1791","1678","113","1222","456","1791","42600","47","037","47037","2010"
"Census Tract 154.04, Davidson County, Tennessee","548","606","358","46","1763","1558","205","802","756","1763","43939","47","037","47037","2010"
"Census Tract 154.05, Davidson County, Tennessee","277","720","646","127","1927","1770","157","1281","489","1927","50769","47","037","47037","2010"
"Census Tract 155.01, Davidson County, Tennessee","409","861","360","44","1786","1674","112","589","1085","1786","49400","47","037","47037","2010"
"Census Tract 155.02, Davidson County, Tennessee","497","832","502","144","2049","1975","74","1201","774","2049","44438","47","037","47037","2010"
"Census Tract 156.09, Davidson County, Tennessee","265","1203","410","34","2119","1912","207","444","1468","2119","50481","47","037","47037","2010"
"Census Tract 156.10, Davidson County, Tennessee","377","1577","1266","247","3687","3467","220","1831","1636","3687","64356","47","037","47037","2010"
"Census Tract 156.12, Davidson County, Tennessee","422","1711","996","72","3374","3201","173","1111","2090","3374","42184","47","037","47037","2010"
"Census Tract 156.13, Davidson County, Tennessee","202","919","485","43","1843","1649","194","411","1238","1843","29212","47","037","47037","2010"
"Census Tract 156.14, Davidson County, Tennessee","228","531","589","123","1579","1471","108","892","579","1579","49676","47","037","47037","2010"
"Census Tract 156.15, Davidson County, Tennessee","220","640","568","103","1617","1531","86","751","780","1617","38822","47","037","47037","2010"
"Census Tract 156.17, Davidson County, Tennessee","171","497","304","95","1099","1067","32","968","99","1099","67344","47","037","47037","2010"
"Census Tract 156.18, Davidson County, Tennessee","100","1024","841","224","2400","2189","211","1598","591","2400","57008","47","037","47037","2010"
"Census Tract 156.19, Davidson County, Tennessee","158","770","841","59","1933","1828","105","1736","92","1933","71019","47","037","47037","2010"
"Census Tract 156.20, Davidson County, Tennessee","246","1167","837","196","2550","2446","104","2088","358","2550","53190","47","037","47037","2010"
"Census Tract 156.22, Davidson County, Tennessee","138","525","609","116","1509","1388","121","1212","176","1509","72340","47","037","47037","2010"
"Census Tract 156.23, Davidson County, Tennessee","447","893","547","189","2237","2076","161","1184","892","2237","50723","47","037","47037","2010"
"Census Tract 156.24, Davidson County, Tennessee","200","1157","542","119","2226","2018","208","1122","896","2226","40918","47","037","47037","2010"
"Census Tract 156.25, Davidson County, Tennessee","300","1208","722","36","2437","2266","171","1618","648","2437","53507","47","037","47037","2010"
"Census Tract 156.26, Davidson County, Tennessee","444","1292","728","239","2901","2703","198","993","1710","2901","35031","47","037","47037","2010"
"Census Tract 156.27, Davidson County, Tennessee","110","435","294","106","988","945","43","865","80","988","51094","47","037","47037","2010"
"Census Tract 156.28, Davidson County, Tennessee","289","986","264","12","1676","1551","125","87","1464","1676","32995","47","037","47037","2010"
"Census Tract 156.29, Davidson County, Tennessee","163","1228","399","56","2302","1846","456","564","1282","2302","44566","47","037","47037","2010"
"Census Tract 156.30, Davidson County, Tennessee","118","462","327","64","1036","971","65","816","155","1036","64205","47","037","47037","2010"
"Census Tract 156.31, Davidson County, Tennessee","319","1087","997","166","2759","2569","190","2333","236","2759","55619","47","037","47037","2010"
"Census Tract 157, Davidson County, Tennessee","167","231","137","63","628","598","30","471","127","628","53241","47","037","47037","2010"
"Census Tract 158.02, Davidson County, Tennessee","726","1016","544","192","2740","2478","262","715","1763","2740","22679","47","037","47037","2010"
"Census Tract 158.03, Davidson County, Tennessee","88","402","203","155","1249","848","401","102","746","1249","30930","47","037","47037","2010"
"Census Tract 158.04, Davidson County, Tennessee","177","1129","431","79","2013","1816","197","436","1380","2013","38314","47","037","47037","2010"
"Census Tract 159, Davidson County, Tennessee","670","164","196","59","1308","1089","219","276","813","1308","15933","47","037","47037","2010"
"Census Tract 160, Davidson County, Tennessee","201","94","17","0","431","312","119","157","155","431","14107","47","037","47037","2010"
"Census Tract 161, Davidson County, Tennessee","326","508","123","0","1080","957","123","225","732","1080","19024","47","037","47037","2010"
"Census Tract 162, Davidson County, Tennessee","741","535","152","12","1618","1440","178","481","959","1618","17123","47","037","47037","2010"
"Census Tract 163, Davidson County, Tennessee","436","359","112","34","1009","941","68","278","663","1009","22762","47","037","47037","2010"
"Census Tract 164, Davidson County, Tennessee","329","408","69","0","965","806","159","192","614","965","25938","47","037","47037","2010"
"Census Tract 165, Davidson County, Tennessee","97","146","44","0","350","287","63","0","287","350","30781","47","037","47037","2010"
"Census Tract 166, Davidson County, Tennessee","407","674","294","0","1797","1375","422","325","1050","1797","32537","47","037","47037","2010"
"Census Tract 167, Davidson County, Tennessee","587","1398","629","49","2890","2663","227","1556","1107","2890","76932","47","037","47037","2010"
"Census Tract 168, Davidson County, Tennessee","292","1150","666","12","2441","2120","321","780","1340","2441","56250","47","037","47037","2010"
"Census Tract 169, Davidson County, Tennessee","280","1018","713","113","2361","2124","237","1279","845","2361","73662","47","037","47037","2010"
"Census Tract 170, Davidson County, Tennessee","232","534","295","73","1229","1134","95","796","338","1229","50185","47","037","47037","2010"
"Census Tract 171, Davidson County, Tennessee","155","447","158","60","898","820","78","547","273","898","52143","47","037","47037","2010"
"Census Tract 172, Davidson County, Tennessee","167","309","103","45","700","624","76","357","267","700","31942","47","037","47037","2010"
"Census Tract 173, Davidson County, Tennessee","211","640","166","171","1317","1188","129","717","471","1317","36268","47","037","47037","2010"
"Census Tract 174.01, Davidson County, Tennessee","142","369","284","61","1015","856","159","384","472","1015","34783","47","037","47037","2010"
"Census Tract 174.02, Davidson County, Tennessee","507","1242","646","115","2875","2510","365","1003","1507","2875","35426","47","037","47037","2010"
"Census Tract 175, Davidson County, Tennessee","376","579","205","39","1410","1199","211","669","530","1410","34702","47","037","47037","2010"
"Census Tract 177.01, Davidson County, Tennessee","159","446","294","41","987","940","47","821","119","987","66848","47","037","47037","2010"
"Census Tract 177.02, Davidson County, Tennessee","269","858","462","18","1708","1607","101","1190","417","1708","78520","47","037","47037","2010"
"Census Tract 178, Davidson County, Tennessee","438","1249","852","125","3085","2664","421","1585","1079","3085","58889","47","037","47037","2010"
"Census Tract 179.01, Davidson County, Tennessee","620","837","495","56","2349","2008","341","1426","582","2349","79643","47","037","47037","2010"
"Census Tract 179.02, Davidson County, Tennessee","696","1037","625","7","2532","2365","167","1627","738","2532","79964","47","037","47037","2010"
"Census Tract 180, Davidson County, Tennessee","626","1058","568","87","2714","2339","375","1506","833","2714","68863","47","037","47037","2010"
"Census Tract 181.01, Davidson County, Tennessee","412","1278","401","74","2473","2165","308","597","1568","2473","30857","47","037","47037","2010"
"Census Tract 181.02, Davidson County, Tennessee","596","714","367","79","1927","1756","171","1138","618","1927","68015","47","037","47037","2010"
"Census Tract 182.01, Davidson County, Tennessee","337","467","414","83","1367","1301","66","1026","275","1367","76950","47","037","47037","2010"
"Census Tract 182.02, Davidson County, Tennessee","559","1968","657","37","3531","3221","310","1072","2149","3531","48079","47","037","47037","2010"
"Census Tract 182.03, Davidson County, Tennessee","107","267","151","30","586","555","31","527","28","586","109375","47","037","47037","2010"
"Census Tract 183.01, Davidson County, Tennessee","549","950","1012","138","2936","2649","287","2005","644","2936","61843","47","037","47037","2010"
"Census Tract 183.02, Davidson County, Tennessee","131","380","534","18","1087","1063","24","998","65","1087","79080","47","037","47037","2010"
"Census Tract 184.01, Davidson County, Tennessee","579","1517","680","74","3203","2850","353","1368","1482","3203","47589","47","037","47037","2010"
"Census Tract 184.04, Davidson County, Tennessee","663","1289","363","53","2399","2368","31","1240","1128","2399","49084","47","037","47037","2010"
"Census Tract 184.05, Davidson County, Tennessee","203","894","712","130","1988","1939","49","1747","192","1988","90276","47","037","47037","2010"
"Census Tract 184.07, Davidson County, Tennessee","109","489","604","106","1377","1308","69","1294","14","1377","104537","47","037","47037","2010"
"Census Tract 184.08, Davidson County, Tennessee","66","457","591","94","1248","1208","40","1190","18","1248","109167","47","037","47037","2010"
"Census Tract 184.09, Davidson County, Tennessee","878","812","367","28","2200","2085","115","1788","297","2200","49492","47","037","47037","2010"
"Census Tract 184.10, Davidson County, Tennessee","442","842","328","14","1790","1626","164","661","965","1790","43556","47","037","47037","2010"
"Census Tract 185, Davidson County, Tennessee","422","1183","484","16","2216","2105","111","1837","268","2216","126205","47","037","47037","2010"
"Census Tract 186.01, Davidson County, Tennessee","193","324","297","4","833","818","15","787","31","833","184500","47","037","47037","2010"
"Census Tract 186.02, Davidson County, Tennessee","375","567","516","54","1628","1512","116","1501","11","1628","137500","47","037","47037","2010"
"Census Tract 187, Davidson County, Tennessee","303","558","436","21","1352","1318","34","1157","161","1352","139583","47","037","47037","2010"
"Census Tract 188.01, Davidson County, Tennessee","387","1095","850","161","2737","2493","244","1886","607","2737","80493","47","037","47037","2010"
"Census Tract 188.03, Davidson County, Tennessee","367","715","542","55","1894","1679","215","1048","631","1894","67644","47","037","47037","2010"
"Census Tract 188.04, Davidson County, Tennessee","346","707","834","123","2010","2010","0","1857","153","2010","89911","47","037","47037","2010"
"Census Tract 189.01, Davidson County, Tennessee","326","629","309","17","1491","1281","210","563","718","1491","42787","47","037","47037","2010"
"Census Tract 189.02, Davidson County, Tennessee","222","482","307","85","1203","1096","107","655","441","1203","54468","47","037","47037","2010"
"Census Tract 189.04, Davidson County, Tennessee","441","874","172","103","1708","1590","118","603","987","1708","32308","47","037","47037","2010"
"Census Tract 189.05, Davidson County, Tennessee","179","842","146","108","1556","1275","281","494","781","1556","41857","47","037","47037","2010"
"Census Tract 190.03, Davidson County, Tennessee","305","756","461","59","1844","1581","263","511","1070","1844","30091","47","037","47037","2010"
"Census Tract 190.04, Davidson County, Tennessee","234","676","339","120","1609","1369","240","634","735","1609","29945","47","037","47037","2010"
"Census Tract 190.05, Davidson County, Tennessee","247","418","202","132","1332","999","333","251","748","1332","28098","47","037","47037","2010"
"Census Tract 190.06, Davidson County, Tennessee","551","746","397","126","1911","1820","91","1122","698","1911","30925","47","037","47037","2010"
"Census Tract 191.05, Davidson County, Tennessee","500","1078","454","95","2467","2127","340","743","1384","2467","36306","47","037","47037","2010"
"Census Tract 191.06, Davidson County, Tennessee","291","955","556","28","2003","1830","173","843","987","2003","52594","47","037","47037","2010"
"Census Tract 191.08, Davidson County, Tennessee","287","442","342","70","1230","1141","89","239","902","1230","32944","47","037","47037","2010"
"Census Tract 191.09, Davidson County, Tennessee","219","836","412","143","1722","1610","112","1266","344","1722","45573","47","037","47037","2010"
"Census Tract 191.10, Davidson County, Tennessee","283","449","391","116","1392","1239","153","1002","237","1392","52175","47","037","47037","2010"
"Census Tract 191.11, Davidson County, Tennessee","189","1007","599","84","2015","1879","136","623","1256","2015","41104","47","037","47037","2010"
"Census Tract 191.12, Davidson County, Tennessee","191","692","321","135","1415","1339","76","816","523","1415","54269","47","037","47037","2010"
"Census Tract 191.14, Davidson County, Tennessee","323","1317","1174","199","3332","3013","319","2647","366","3332","71767","47","037","47037","2010"
"Census Tract 191.15, Davidson County, Tennessee","144","596","539","104","1398","1383","15","1311","72","1398","91250","47","037","47037","2010"
"Census Tract 191.16, Davidson County, Tennessee","366","1451","696","109","2944","2622","322","1542","1080","2944","72597","47","037","47037","2010"
"Census Tract 191.17, Davidson County, Tennessee","143","285","631","195","1275","1254","21","1178","76","1275","89038","47","037","47037","2010"
"Census Tract 191.18, Davidson County, Tennessee","231","1480","490","62","2552","2263","289","403","1860","2552","30343","47","037","47037","2010"
"Census Tract 192, Davidson County, Tennessee","397","690","357","30","1673","1474","199","694","780","1673","31875","47","037","47037","2010"
"Census Tract 193, Davidson County, Tennessee","679","458","154","0","1407","1291","116","57","1234","1407","10577","47","037","47037","2010"
"Census Tract 194, Davidson County, Tennessee","575","733","324","9","1970","1641","329","613","1028","1970","23533","47","037","47037","2010"
"Census Tract 195, Davidson County, Tennessee","356","1132","274","10","2541","1772","769","505","1267","2541","42468","47","037","47037","2010"
"Census Tract 196, Davidson County, Tennessee","443","786","366","30","1847","1625","222","733","892","1847","40170","47","037","47037","2010"
"Census Tract 9801, Davidson County, Tennessee","0","0","0","0","0","0","0","0","0","0","-666666666","47","037","47037","2010"
"Census Tract 9802, Davidson County, Tennessee","0","0","0","0","0","0","0","0","0","0","-666666666","47","037","47037","2010"
"Census Tract 9550.01, Decatur County, Tennessee","336","261","97","35","1382","729","653","643","86","1382","30117","47","039","47039","2010"
"Census Tract 9550.02, Decatur County, Tennessee","1026","636","392","94","2668","2148","520","1545","603","2668","28214","47","039","47039","2010"
"Census Tract 9551.01, Decatur County, Tennessee","265","283","211","40","973","799","174","650","149","973","31188","47","039","47039","2010"
"Census Tract 9551.02, Decatur County, Tennessee","586","339","366","18","1828","1309","519","1054","255","1828","30402","47","039","47039","2010"
"Census Tract 9201.01, DeKalb County, Tennessee","243","241","254","63","1590","801","789","575","226","1590","38782","47","041","47041","2010"
"Census Tract 9201.02, DeKalb County, Tennessee","578","460","528","97","2180","1663","517","1399","264","2180","37926","47","041","47041","2010"
"Census Tract 9202, DeKalb County, Tennessee","878","881","662","109","2794","2530","264","1473","1057","2794","33506","47","041","47041","2010"
"Census Tract 9203, DeKalb County, Tennessee","736","828","542","65","2715","2171","544","1733","438","2715","29771","47","041","47041","2010"
"Census Tract 601, Dickson County, Tennessee","399","547","578","94","1703","1618","85","1414","204","1703","47941","47","043","47043","2010"
"Census Tract 602, Dickson County, Tennessee","598","943","581","204","2662","2326","336","1885","441","2662","46676","47","043","47043","2010"
"Census Tract 603, Dickson County, Tennessee","591","842","709","146","2471","2288","183","1604","684","2471","43592","47","043","47043","2010"
"Census Tract 604.01, Dickson County, Tennessee","213","447","346","68","1202","1074","128","941","133","1202","65469","47","043","47043","2010"
"Census Tract 604.02, Dickson County, Tennessee","428","894","802","65","2468","2189","279","1780","409","2468","52936","47","043","47043","2010"
"Census Tract 605.01, Dickson County, Tennessee","730","941","681","137","2580","2489","91","1672","817","2580","43299","47","043","47043","2010"
"Census Tract 605.02, Dickson County, Tennessee","416","295","404","85","1245","1200","45","846","354","1245","43750","47","043","47043","2010"
"Census Tract 606.01, Dickson County, Tennessee","540","555","443","23","1690","1561","129","1090","471","1690","29534","47","043","47043","2010"
"Census Tract 606.02, Dickson County, Tennessee","640","1196","518","76","2567","2430","137","1339","1091","2567","32299","47","043","47043","2010"
"Census Tract 607, Dickson County, Tennessee","479","652","521","62","1877","1714","163","1421","293","1877","45190","47","043","47043","2010"
"Census Tract 9640, Dyer County, Tennessee","758","1008","694","116","2802","2576","226","1815","761","2802","41176","47","045","47045","2010"
"Census Tract 9642, Dyer County, Tennessee","944","985","594","45","2865","2568","297","1585","983","2865","38474","47","045","47045","2010"
"Census Tract 9643, Dyer County, Tennessee","976","825","522","39","2632","2362","270","1102","1260","2632","23942","47","045","47045","2010"
"Census Tract 9644, Dyer County, Tennessee","698","1191","576","39","2971","2504","467","1155","1349","2971","26818","47","045","47045","2010"
"Census Tract 9645, Dyer County, Tennessee","193","319","319","69","952","900","52","696","204","952","49656","47","045","47045","2010"
"Census Tract 9646, Dyer County, Tennessee","305","345","299","64","1162","1013","149","817","196","1162","34936","47","045","47045","2010"
"Census Tract 9648, Dyer County, Tennessee","324","496","271","145","1364","1236","128","849","387","1364","39093","47","045","47045","2010"
"Census Tract 9649, Dyer County, Tennessee","550","592","666","112","1984","1920","64","1778","142","1984","41026","47","045","47045","2010"
"Census Tract 603, Fayette County, Tennessee","529","344","301","67","1365","1241","124","885","356","1365","34813","47","047","47047","2010"
"Census Tract 604.01, Fayette County, Tennessee","450","211","345","59","1123","1065","58","1018","47","1123","66250","47","047","47047","2010"
"Census Tract 604.02, Fayette County, Tennessee","197","444","430","43","1267","1114","153","994","120","1267","66786","47","047","47047","2010"
"Census Tract 604.03, Fayette County, Tennessee","389","398","623","93","1594","1503","91","1442","61","1594","78750","47","047","47047","2010"
"Census Tract 604.04, Fayette County, Tennessee","326","673","545","69","1827","1613","214","1362","251","1827","59093","47","047","47047","2010"
"Census Tract 605.01, Fayette County, Tennessee","360","558","332","69","1485","1319","166","938","381","1485","50391","47","047","47047","2010"
"Census Tract 605.02, Fayette County, Tennessee","514","564","379","64","1719","1521","198","1198","323","1719","42923","47","047","47047","2010"
"Census Tract 606, Fayette County, Tennessee","418","372","471","93","1601","1354","247","1051","303","1601","45643","47","047","47047","2010"
"Census Tract 607.01, Fayette County, Tennessee","213","240","311","77","896","841","55","749","92","896","68040","47","047","47047","2010"
"Census Tract 607.02, Fayette County, Tennessee","255","272","293","99","1024","919","105","805","114","1024","64583","47","047","47047","2010"
"Census Tract 608, Fayette County, Tennessee","264","313","373","58","1076","1008","68","802","206","1076","56597","47","047","47047","2010"
"Census Tract 9650, Fentress County, Tennessee","494","660","181","54","1691","1389","302","1081","308","1691","27837","47","049","47049","2010"
"Census Tract 9651, Fentress County, Tennessee","1126","597","353","42","2495","2118","377","1291","827","2495","18835","47","049","47049","2010"
"Census Tract 9652, Fentress County, Tennessee","658","762","510","155","2529","2085","444","1686","399","2529","39887","47","049","47049","2010"
"Census Tract 9653, Fentress County, Tennessee","703","602","423","11","2045","1739","306","1591","148","2045","32012","47","049","47049","2010"
"Census Tract 9601, Franklin County, Tennessee","549","430","289","95","1622","1363","259","1115","248","1622","36840","47","051","47051","2010"
"Census Tract 9602.01, Franklin County, Tennessee","690","768","632","152","2766","2242","524","1937","305","2766","53567","47","051","47051","2010"
"Census Tract 9602.02, Franklin County, Tennessee","630","669","679","77","2225","2055","170","1754","301","2225","49348","47","051","47051","2010"
"Census Tract 9603, Franklin County, Tennessee","402","383","307","51","1691","1143","548","995","148","1691","40521","47","051","47051","2010"
"Census Tract 9604, Franklin County, Tennessee","1140","1095","608","211","3518","3054","464","2056","998","3518","38375","47","051","47051","2010"
"Census Tract 9605, Franklin County, Tennessee","588","575","379","13","1783","1555","228","1026","529","1783","29851","47","051","47051","2010"
"Census Tract 9606, Franklin County, Tennessee","800","790","375","80","2184","2045","139","1535","510","2184","34063","47","051","47051","2010"
"Census Tract 9607, Franklin County, Tennessee","390","429","241","59","1406","1119","287","852","267","1406","55768","47","051","47051","2010"
"Census Tract 9608, Franklin County, Tennessee","389","409","326","50","1349","1174","175","907","267","1349","35511","47","051","47051","2010"
"Census Tract 9661, Gibson County, Tennessee","373","351","180","38","1099","942","157","703","239","1099","35667","47","053","47053","2010"
"Census Tract 9662, Gibson County, Tennessee","631","406","378","60","1575","1475","100","1135","340","1575","36441","47","053","47053","2010"
"Census Tract 9663, Gibson County, Tennessee","301","281","268","50","1111","900","211","754","146","1111","40179","47","053","47053","2010"
"Census Tract 9664, Gibson County, Tennessee","706","897","492","49","2276","2144","132","1477","667","2276","33500","47","053","47053","2010"
"Census Tract 9665, Gibson County, Tennessee","848","684","537","74","2541","2143","398","1367","776","2541","33904","47","053","47053","2010"
"Census Tract 9666, Gibson County, Tennessee","230","262","160","21","754","673","81","573","100","754","46544","47","053","47053","2010"
"Census Tract 9667, Gibson County, Tennessee","847","917","668","33","2673","2465","208","1758","707","2673","32007","47","053","47053","2010"
"Census Tract 9668, Gibson County, Tennessee","194","133","168","31","596","526","70","414","112","596","37016","47","053","47053","2010"
"Census Tract 9669, Gibson County, Tennessee","686","576","190","31","1697","1483","214","785","698","1697","19010","47","053","47053","2010"
"Census Tract 9670, Gibson County, Tennessee","1228","1172","717","59","3513","3176","337","2112","1064","3513","34708","47","053","47053","2010"
"Census Tract 9671, Gibson County, Tennessee","297","599","870","53","1996","1819","177","1568","251","1996","65486","47","053","47053","2010"
"Census Tract 9673, Gibson County, Tennessee","154","144","88","22","496","408","88","322","86","496","38654","47","053","47053","2010"
"Census Tract 9674, Gibson County, Tennessee","361","613","348","72","1556","1394","162","1104","290","1556","39178","47","053","47053","2010"
"Census Tract 9801, Gibson County, Tennessee","0","0","0","0","0","0","0","0","0","0","-666666666","47","053","47053","2010"
"Census Tract 9201, Giles County, Tennessee","344","453","428","73","1525","1298","227","1096","202","1525","44228","47","055","47055","2010"
"Census Tract 9202, Giles County, Tennessee","531","591","389","93","1904","1604","300","1156","448","1904","39459","47","055","47055","2010"
"Census Tract 9203, Giles County, Tennessee","1021","716","538","116","3038","2391","647","1756","635","3038","36553","47","055","47055","2010"
"Census Tract 9204, Giles County, Tennessee","563","488","309","49","1553","1409","144","917","492","1553","39020","47","055","47055","2010"
"Census Tract 9205, Giles County, Tennessee","828","853","379","74","2324","2134","190","1435","699","2324","29865","47","055","47055","2010"
"Census Tract 9206, Giles County, Tennessee","353","456","197","74","1275","1080","195","875","205","1275","35172","47","055","47055","2010"
"Census Tract 9207, Giles County, Tennessee","202","274","83","70","800","629","171","597","32","800","52386","47","055","47055","2010"
"Census Tract 9208, Giles County, Tennessee","427","422","255","48","1390","1152","238","906","246","1390","36296","47","055","47055","2010"
"Census Tract 5001, Grainger County, Tennessee","472","484","353","105","1841","1414","427","1258","156","1841","30227","47","057","47057","2010"
"Census Tract 5002, Grainger County, Tennessee","593","549","584","97","1998","1823","175","1530","293","1998","35030","47","057","47057","2010"
"Census Tract 5003, Grainger County, Tennessee","877","882","477","155","3073","2391","682","1927","464","3073","26225","47","057","47057","2010"
"Census Tract 5004.01, Grainger County, Tennessee","473","228","226","63","1118","990","128","799","191","1118","29844","47","057","47057","2010"
"Census Tract 5004.02, Grainger County, Tennessee","722","783","479","21","2740","2005","735","1599","406","2740","29588","47","057","47057","2010"
"Census Tract 901, Greene County, Tennessee","1118","992","534","103","3208","2747","461","1632","1115","3208","20610","47","059","47059","2010"
"Census Tract 902, Greene County, Tennessee","378","402","249","14","1077","1043","34","846","197","1077","45237","47","059","47059","2010"
"Census Tract 903, Greene County, Tennessee","873","929","586","205","2822","2593","229","1628","965","2822","38530","47","059","47059","2010"
"Census Tract 904, Greene County, Tennessee","665","888","430","59","2324","2042","282","1362","680","2324","40926","47","059","47059","2010"
"Census Tract 905, Greene County, Tennessee","833","1221","824","89","3312","2967","345","2233","734","3312","42043","47","059","47059","2010"
"Census Tract 906, Greene County, Tennessee","480","629","352","47","1740","1508","232","1298","210","1740","42341","47","059","47059","2010"
"Census Tract 907, Greene County, Tennessee","308","316","369","47","1182","1040","142","813","227","1182","39405","47","059","47059","2010"
"Census Tract 908, Greene County, Tennessee","483","659","467","138","1920","1747","173","1354","393","1920","36113","47","059","47059","2010"
"Census Tract 909, Greene County, Tennessee","617","699","644","113","2321","2073","248","1517","556","2321","45084","47","059","47059","2010"
"Census Tract 910, Greene County, Tennessee","1115","952","851","160","3481","3078","403","2375","703","3481","36484","47","059","47059","2010"
"Census Tract 911, Greene County, Tennessee","442","540","481","23","1700","1486","214","1364","122","1700","38017","47","059","47059","2010"
"Census Tract 912, Greene County, Tennessee","407","686","304","94","1705","1491","214","1130","361","1705","32253","47","059","47059","2010"
"Census Tract 913, Greene County, Tennessee","698","702","473","46","2058","1919","139","1560","359","2058","29360","47","059","47059","2010"
"Census Tract 914, Greene County, Tennessee","483","414","285","26","1326","1208","118","864","344","1326","32681","47","059","47059","2010"
"Census Tract 915, Greene County, Tennessee","407","452","298","35","1442","1192","250","911","281","1442","36841","47","059","47059","2010"
"Census Tract 9550, Grundy County, Tennessee","350","463","230","11","1373","1054","319","849","205","1373","22474","47","061","47061","2010"
"Census Tract 9551, Grundy County, Tennessee","244","260","163","5","924","672","252","485","187","924","34573","47","061","47061","2010"
"Census Tract 9552, Grundy County, Tennessee","717","506","190","52","1702","1465","237","1217","248","1702","24788","47","061","47061","2010"
"Census Tract 9553, Grundy County, Tennessee","811","675","474","107","2429","2067","362","1691","376","2429","27069","47","061","47061","2010"
"Census Tract 1001, Hamblen County, Tennessee","1134","971","559","54","2891","2718","173","1427","1291","2891","29195","47","063","47063","2010"
"Census Tract 1002, Hamblen County, Tennessee","798","873","533","138","2492","2342","150","1563","779","2492","38377","47","063","47063","2010"
"Census Tract 1003, Hamblen County, Tennessee","440","507","98","115","1356","1160","196","460","700","1356","22995","47","063","47063","2010"
"Census Tract 1004, Hamblen County, Tennessee","959","798","487","194","2677","2438","239","1318","1120","2677","33523","47","063","47063","2010"
"Census Tract 1005, Hamblen County, Tennessee","447","469","338","58","1429","1312","117","1077","235","1429","46207","47","063","47063","2010"
"Census Tract 1006, Hamblen County, Tennessee","772","1132","658","165","3033","2727","306","2103","624","3033","42218","47","063","47063","2010"
"Census Tract 1007, Hamblen County, Tennessee","605","1026","541","85","2459","2257","202","1896","361","2459","47932","47","063","47063","2010"
"Census Tract 1008, Hamblen County, Tennessee","438","462","334","68","1362","1302","60","907","395","1362","26849","47","063","47063","2010"
"Census Tract 1009, Hamblen County, Tennessee","719","617","454","94","2165","1884","281","1344","540","2165","40197","47","063","47063","2010"
"Census Tract 1010, Hamblen County, Tennessee","702","607","558","117","2187","1984","203","1665","319","2187","41458","47","063","47063","2010"
"Census Tract 1011, Hamblen County, Tennessee","549","728","565","74","2131","1916","215","1738","178","2131","50449","47","063","47063","2010"
"Census Tract 1012, Hamblen County, Tennessee","703","770","859","79","2551","2411","140","1940","471","2551","56233","47","063","47063","2010"
"Census Tract 4, Hamilton County, Tennessee","662","568","182","50","1664","1462","202","527","935","1664","21823","47","065","47065","2010"
"Census Tract 6, Hamilton County, Tennessee","398","493","525","26","1797","1442","355","988","454","1797","52679","47","065","47065","2010"
"Census Tract 7, Hamilton County, Tennessee","341","785","504","113","2025","1743","282","1072","671","2025","68598","47","065","47065","2010"
"Census Tract 8, Hamilton County, Tennessee","144","248","108","8","674","508","166","193","315","674","27917","47","065","47065","2010"
"Census Tract 11, Hamilton County, Tennessee","239","334","114","29","861","716","145","245","471","861","16344","47","065","47065","2010"
"Census Tract 12, Hamilton County, Tennessee","592","544","229","0","1528","1365","163","435","930","1528","23894","47","065","47065","2010"
"Census Tract 13, Hamilton County, Tennessee","138","295","173","49","866","655","211","245","410","866","25787","47","065","47065","2010"
"Census Tract 14, Hamilton County, Tennessee","250","230","151","0","879","631","248","333","298","879","28456","47","065","47065","2010"
"Census Tract 16, Hamilton County, Tennessee","1107","328","10","17","1732","1462","270","0","1462","1732","9277","47","065","47065","2010"
"Census Tract 18, Hamilton County, Tennessee","240","622","265","88","1450","1215","235","764","451","1450","42171","47","065","47065","2010"
"Census Tract 19, Hamilton County, Tennessee","765","599","154","33","1795","1551","244","493","1058","1795","15245","47","065","47065","2010"
"Census Tract 20, Hamilton County, Tennessee","258","213","44","12","688","527","161","139","388","688","16156","47","065","47065","2010"
"Census Tract 23, Hamilton County, Tennessee","195","145","158","0","571","498","73","308","190","571","26689","47","065","47065","2010"
"Census Tract 24, Hamilton County, Tennessee","595","412","347","47","1708","1401","307","792","609","1708","26208","47","065","47065","2010"
"Census Tract 25, Hamilton County, Tennessee","713","885","231","48","2203","1877","326","696","1181","2203","19641","47","065","47065","2010"
"Census Tract 26, Hamilton County, Tennessee","226","271","276","25","979","798","181","282","516","979","23649","47","065","47065","2010"
"Census Tract 28, Hamilton County, Tennessee","403","874","540","33","2017","1850","167","1135","715","2017","45066","47","065","47065","2010"
"Census Tract 29, Hamilton County, Tennessee","397","386","261","47","1373","1091","282","558","533","1373","38750","47","065","47065","2010"
"Census Tract 30, Hamilton County, Tennessee","189","516","304","41","1186","1050","136","591","459","1186","40238","47","065","47065","2010"
"Census Tract 31, Hamilton County, Tennessee","336","322","74","0","809","732","77","143","589","809","22273","47","065","47065","2010"
"Census Tract 32, Hamilton County, Tennessee","464","584","263","18","1624","1329","295","1061","268","1624","32725","47","065","47065","2010"
"Census Tract 33, Hamilton County, Tennessee","658","1155","743","242","3087","2798","289","1970","828","3087","37687","47","065","47065","2010"
"Census Tract 34, Hamilton County, Tennessee","477","1090","458","102","2367","2127","240","684","1443","2367","35958","47","065","47065","2010"
"Census Tract 101.01, Hamilton County, Tennessee","506","726","701","237","2316","2170","146","1797","373","2316","54299","47","065","47065","2010"
"Census Tract 101.03, Hamilton County, Tennessee","315","398","615","37","1467","1365","102","1165","200","1467","58163","47","065","47065","2010"
"Census Tract 101.04, Hamilton County, Tennessee","416","437","438","112","1666","1403","263","1272","131","1666","44939","47","065","47065","2010"
"Census Tract 102.01, Hamilton County, Tennessee","238","502","344","120","1401","1204","197","1120","84","1401","62300","47","065","47065","2010"
"Census Tract 102.02, Hamilton County, Tennessee","470","536","317","167","1725","1490","235","1279","211","1725","41344","47","065","47065","2010"
"Census Tract 103.03, Hamilton County, Tennessee","211","389","344","115","1068","1059","9","915","144","1068","46823","47","065","47065","2010"
"Census Tract 103.04, Hamilton County, Tennessee","462","583","717","148","2031","1910","121","1646","264","2031","67823","47","065","47065","2010"
"Census Tract 103.05, Hamilton County, Tennessee","287","447","415","33","1302","1182","120","1025","157","1302","59750","47","065","47065","2010"
"Census Tract 103.06, Hamilton County, Tennessee","319","543","514","79","1543","1455","88","1083","372","1543","47632","47","065","47065","2010"
"Census Tract 103.07, Hamilton County, Tennessee","825","778","620","104","2496","2327","169","1565","762","2496","40529","47","065","47065","2010"
"Census Tract 104.11, Hamilton County, Tennessee","470","859","794","105","2460","2228","232","2074","154","2460","68257","47","065","47065","2010"
"Census Tract 104.12, Hamilton County, Tennessee","489","575","752","101","1953","1917","36","1517","400","1953","52854","47","065","47065","2010"
"Census Tract 104.13, Hamilton County, Tennessee","360","536","466","144","1588","1506","82","1311","195","1588","83269","47","065","47065","2010"
"Census Tract 104.31, Hamilton County, Tennessee","712","1160","619","260","2940","2751","189","1854","897","2940","60687","47","065","47065","2010"
"Census Tract 104.32, Hamilton County, Tennessee","814","1066","921","142","3217","2943","274","1963","980","3217","68420","47","065","47065","2010"
"Census Tract 104.33, Hamilton County, Tennessee","679","868","619","76","2283","2242","41","1253","989","2283","39375","47","065","47065","2010"
"Census Tract 104.34, Hamilton County, Tennessee","328","177","208","49","874","762","112","577","185","874","51250","47","065","47065","2010"
"Census Tract 104.35, Hamilton County, Tennessee","780","1048","560","168","2798","2556","242","1892","664","2798","48793","47","065","47065","2010"
"Census Tract 105.01, Hamilton County, Tennessee","668","995","824","159","2886","2646","240","2107","539","2886","49343","47","065","47065","2010"
"Census Tract 105.02, Hamilton County, Tennessee","345","707","315","125","1576","1492","84","905","587","1576","58239","47","065","47065","2010"
"Census Tract 106, Hamilton County, Tennessee","354","644","204","46","1467","1248","219","802","446","1467","34504","47","065","47065","2010"
"Census Tract 107, Hamilton County, Tennessee","348","590","445","5","1522","1388","134","548","840","1522","31500","47","065","47065","2010"
"Census Tract 108, Hamilton County, Tennessee","471","890","594","20","2237","1975","262","846","1129","2237","31801","47","065","47065","2010"
"Census Tract 109.01, Hamilton County, Tennessee","146","324","104","102","744","676","68","329","347","744","32647","47","065","47065","2010"
"Census Tract 109.02, Hamilton County, Tennessee","185","170","34","0","443","389","54","306","83","443","21172","47","065","47065","2010"
"Census Tract 109.03, Hamilton County, Tennessee","831","1253","726","76","3335","2886","449","959","1927","3335","35905","47","065","47065","2010"
"Census Tract 110.01, Hamilton County, Tennessee","218","305","137","8","705","668","37","615","53","705","45660","47","065","47065","2010"
"Census Tract 110.02, Hamilton County, Tennessee","399","919","827","192","2602","2337","265","2005","332","2602","77938","47","065","47065","2010"
"Census Tract 111, Hamilton County, Tennessee","875","892","780","110","2941","2657","284","2241","416","2941","84236","47","065","47065","2010"
"Census Tract 112.01, Hamilton County, Tennessee","652","951","970","124","2912","2697","215","2151","546","2912","72614","47","065","47065","2010"
"Census Tract 112.03, Hamilton County, Tennessee","413","544","639","137","1874","1733","141","1132","601","1874","70196","47","065","47065","2010"
"Census Tract 112.04, Hamilton County, Tennessee","451","585","790","145","2059","1971","88","1665","306","2059","53444","47","065","47065","2010"
"Census Tract 113.11, Hamilton County, Tennessee","451","803","695","140","2329","2089","240","1414","675","2329","54219","47","065","47065","2010"
"Census Tract 113.14, Hamilton County, Tennessee","265","524","759","128","1764","1676","88","1626","50","1764","79113","47","065","47065","2010"
"Census Tract 113.21, Hamilton County, Tennessee","489","1109","929","116","3085","2643","442","1767","876","3085","60031","47","065","47065","2010"
"Census Tract 113.23, Hamilton County, Tennessee","533","711","711","261","2462","2216","246","1764","452","2462","71089","47","065","47065","2010"
"Census Tract 113.24, Hamilton County, Tennessee","280","353","614","124","1371","1371","0","1320","51","1371","109306","47","065","47065","2010"
"Census Tract 113.25, Hamilton County, Tennessee","211","742","815","182","2019","1950","69","1793","157","2019","91600","47","065","47065","2010"
"Census Tract 113.26, Hamilton County, Tennessee","381","1059","712","41","2310","2193","117","1137","1056","2310","63685","47","065","47065","2010"
"Census Tract 114.02, Hamilton County, Tennessee","593","905","656","360","2751","2514","237","1712","802","2751","41630","47","065","47065","2010"
"Census Tract 114.11, Hamilton County, Tennessee","648","442","293","87","1772","1470","302","1027","443","1772","41449","47","065","47065","2010"
"Census Tract 114.13, Hamilton County, Tennessee","580","1179","1079","192","3350","3030","320","2175","855","3350","59951","47","065","47065","2010"
"Census Tract 114.42, Hamilton County, Tennessee","323","426","322","104","1218","1175","43","753","422","1218","45056","47","065","47065","2010"
"Census Tract 114.43, Hamilton County, Tennessee","805","1157","411","150","2839","2523","316","1556","967","2839","35453","47","065","47065","2010"
"Census Tract 114.44, Hamilton County, Tennessee","563","696","292","36","1828","1587","241","1055","532","1828","27771","47","065","47065","2010"
"Census Tract 114.45, Hamilton County, Tennessee","430","1164","391","19","2016","2004","12","840","1164","2016","35000","47","065","47065","2010"
"Census Tract 114.46, Hamilton County, Tennessee","309","683","467","46","1596","1505","91","988","517","1596","50619","47","065","47065","2010"
"Census Tract 114.47, Hamilton County, Tennessee","394","895","1120","137","2773","2546","227","2348","198","2773","66643","47","065","47065","2010"
"Census Tract 116, Hamilton County, Tennessee","694","1090","668","160","2785","2612","173","1323","1289","2785","34177","47","065","47065","2010"
"Census Tract 117, Hamilton County, Tennessee","552","983","402","26","2103","1963","140","1335","628","2103","42887","47","065","47065","2010"
"Census Tract 118, Hamilton County, Tennessee","781","915","823","199","2938","2718","220","1654","1064","2938","43735","47","065","47065","2010"
"Census Tract 119, Hamilton County, Tennessee","223","368","182","17","880","790","90","316","474","880","29352","47","065","47065","2010"
"Census Tract 120, Hamilton County, Tennessee","204","323","179","18","821","724","97","645","79","821","115147","47","065","47065","2010"
"Census Tract 121, Hamilton County, Tennessee","572","998","749","93","2665","2412","253","1970","442","2665","53598","47","065","47065","2010"
"Census Tract 122, Hamilton County, Tennessee","581","482","55","13","1473","1131","342","295","836","1473","13991","47","065","47065","2010"
"Census Tract 123, Hamilton County, Tennessee","830","718","293","64","2259","1905","354","1040","865","2259","27844","47","065","47065","2010"
"Census Tract 124, Hamilton County, Tennessee","363","567","108","40","1374","1078","296","309","769","1374","23049","47","065","47065","2010"
"Census Tract 9801, Hamilton County, Tennessee","0","0","0","0","0","0","0","0","0","0","-666666666","47","065","47065","2010"
"Census Tract 9802, Hamilton County, Tennessee","15","29","23","0","67","67","0","67","0","67","83125","47","065","47065","2010"
"Census Tract 9605, Hancock County, Tennessee","571","317","200","13","1403","1101","302","979","122","1403","26086","47","067","47067","2010"
"Census Tract 9606, Hancock County, Tennessee","967","556","327","57","2176","1907","269","1173","734","2176","21211","47","067","47067","2010"
"Census Tract 9501, Hardeman County, Tennessee","509","499","409","54","1812","1471","341","1213","258","1812","35101","47","069","47069","2010"
"Census Tract 9502, Hardeman County, Tennessee","396","412","204","110","1369","1122","247","799","323","1369","29111","47","069","47069","2010"
"Census Tract 9503, Hardeman County, Tennessee","593","366","289","114","1641","1362","279","844","518","1641","39325","47","069","47069","2010"
"Census Tract 9504, Hardeman County, Tennessee","724","1009","340","62","2603","2135","468","1470","665","2603","27309","47","069","47069","2010"
"Census Tract 9505, Hardeman County, Tennessee","620","726","449","57","2123","1852","271","1511","341","2123","37212","47","069","47069","2010"
"Census Tract 9506, Hardeman County, Tennessee","347","394","267","43","1359","1051","308","745","306","1359","33021","47","069","47069","2010"
"Census Tract 9201, Hardin County, Tennessee","566","602","277","80","1836","1525","311","1226","299","1836","27659","47","071","47071","2010"
"Census Tract 9202, Hardin County, Tennessee","821","635","446","32","2621","1934","687","1630","304","2621","33033","47","071","47071","2010"
"Census Tract 9203, Hardin County, Tennessee","628","499","340","50","1668","1517","151","1187","330","1668","42718","47","071","47071","2010"
"Census Tract 9204, Hardin County, Tennessee","978","540","442","13","2268","1973","295","1071","902","2268","24075","47","071","47071","2010"
"Census Tract 9205, Hardin County, Tennessee","756","907","502","83","3007","2248","759","1854","394","3007","32114","47","071","47071","2010"
"Census Tract 9206, Hardin County, Tennessee","461","541","253","53","2438","1308","1130","1144","164","2438","29566","47","071","47071","2010"
"Census Tract 501, Hawkins County, Tennessee","570","576","441","65","2023","1652","371","1323","329","2023","30068","47","073","47073","2010"
"Census Tract 502, Hawkins County, Tennessee","812","693","528","81","2490","2114","376","1805","309","2490","38170","47","073","47073","2010"
"Census Tract 503.01, Hawkins County, Tennessee","1281","512","332","12","2431","2137","294","1126","1011","2431","21621","47","073","47073","2010"
"Census Tract 503.02, Hawkins County, Tennessee","793","358","325","48","1870","1524","346","1087","437","1870","28287","47","073","47073","2010"
"Census Tract 504, Hawkins County, Tennessee","682","926","552","104","2408","2264","144","1728","536","2408","41157","47","073","47073","2010"
"Census Tract 505.01, Hawkins County, Tennessee","432","880","279","132","1886","1723","163","1495","228","1886","36065","47","073","47073","2010"
"Census Tract 505.02, Hawkins County, Tennessee","372","453","412","64","1449","1301","148","1060","241","1449","42168","47","073","47073","2010"
"Census Tract 505.03, Hawkins County, Tennessee","557","830","480","87","2134","1954","180","1252","702","2134","38949","47","073","47073","2010"
"Census Tract 506.01, Hawkins County, Tennessee","795","1298","525","61","2801","2679","122","1698","981","2801","33375","47","073","47073","2010"
"Census Tract 506.02, Hawkins County, Tennessee","533","534","605","107","1954","1779","175","1564","215","1954","54337","47","073","47073","2010"
"Census Tract 507, Hawkins County, Tennessee","585","533","227","53","1643","1398","245","1177","221","1643","28295","47","073","47073","2010"
"Census Tract 508, Hawkins County, Tennessee","622","829","386","84","2225","1921","304","1725","196","2225","34536","47","073","47073","2010"
"Census Tract 509, Hawkins County, Tennessee","494","484","217","28","1342","1223","119","973","250","1342","33438","47","073","47073","2010"
"Census Tract 9301, Haywood County, Tennessee","343","344","294","85","1097","1066","31","846","220","1097","36579","47","075","47075","2010"
"Census Tract 9302, Haywood County, Tennessee","337","232","134","0","777","703","74","609","94","777","26275","47","075","47075","2010"
"Census Tract 9303.01, Haywood County, Tennessee","627","668","362","67","2017","1724","293","1087","637","2017","38580","47","075","47075","2010"
"Census Tract 9303.02, Haywood County, Tennessee","404","492","322","50","1313","1268","45","567","701","1313","27443","47","075","47075","2010"
"Census Tract 9304, Haywood County, Tennessee","542","678","424","25","1863","1669","194","979","690","1863","32643","47","075","47075","2010"
"Census Tract 9305, Haywood County, Tennessee","315","427","215","58","1259","1015","244","774","241","1259","32938","47","075","47075","2010"
"Census Tract 9750, Henderson County, Tennessee","373","261","360","83","1433","1077","356","854","223","1433","39191","47","077","47077","2010"
"Census Tract 9751, Henderson County, Tennessee","389","654","369","84","1629","1496","133","1313","183","1629","37074","47","077","47077","2010"
"Census Tract 9752, Henderson County, Tennessee","501","736","706","171","2452","2114","338","1804","310","2452","46912","47","077","47077","2010"
"Census Tract 9753, Henderson County, Tennessee","910","1209","752","61","3191","2932","259","2127","805","3191","42159","47","077","47077","2010"
"Census Tract 9754, Henderson County, Tennessee","776","711","297","16","2176","1800","376","1034","766","2176","23945","47","077","47077","2010"
"Census Tract 9755, Henderson County, Tennessee","480","479","341","131","1760","1431","329","1288","143","1760","40040","47","077","47077","2010"
"Census Tract 9690, Henry County, Tennessee","835","548","521","13","3270","1917","1353","1723","194","3270","45453","47","079","47079","2010"
"Census Tract 9691, Henry County, Tennessee","384","462","366","23","1447","1235","212","1000","235","1447","40387","47","079","47079","2010"
"Census Tract 9692, Henry County, Tennessee","239","293","161","25","773","718","55","511","207","773","43182","47","079","47079","2010"
"Census Tract 9693, Henry County, Tennessee","645","449","213","84","1687","1391","296","829","562","1687","22102","47","079","47079","2010"
"Census Tract 9694, Henry County, Tennessee","517","314","191","13","1171","1035","136","628","407","1171","25850","47","079","47079","2010"
"Census Tract 9695, Henry County, Tennessee","999","719","509","84","2575","2311","264","1620","691","2575","29182","47","079","47079","2010"
"Census Tract 9696, Henry County, Tennessee","978","957","1005","44","3249","2984","265","2476","508","3249","42908","47","079","47079","2010"
"Census Tract 9697, Henry County, Tennessee","372","455","190","20","1719","1037","682","882","155","1719","36614","47","079","47079","2010"
"Census Tract 9698, Henry County, Tennessee","330","318","175","83","1081","906","175","793","113","1081","38984","47","079","47079","2010"
"Census Tract 9501, Hickman County, Tennessee","484","567","647","194","2101","1892","209","1450","442","2101","44266","47","081","47081","2010"
"Census Tract 9502, Hickman County, Tennessee","589","950","920","134","2936","2593","343","2082","511","2936","42820","47","081","47081","2010"
"Census Tract 9503.01, Hickman County, Tennessee","554","424","196","92","1361","1266","95","868","398","1361","33520","47","081","47081","2010"
"Census Tract 9503.02, Hickman County, Tennessee","679","667","417","113","2125","1876","249","1490","386","2125","40508","47","081","47081","2010"
"Census Tract 9504, Hickman County, Tennessee","264","346","293","0","1012","903","109","733","170","1012","41128","47","081","47081","2010"
"Census Tract 9505, Hickman County, Tennessee","120","254","116","0","592","490","102","412","78","592","48984","47","081","47081","2010"
"Census Tract 1201, Houston County, Tennessee","503","454","228","0","1381","1185","196","913","272","1381","36486","47","083","47083","2010"
"Census Tract 1202, Houston County, Tennessee","343","325","213","39","1078","920","158","568","352","1078","32210","47","083","47083","2010"
"Census Tract 1203, Houston County, Tennessee","530","390","318","49","1704","1287","417","1014","273","1704","32889","47","083","47083","2010"
"Census Tract 1301, Humphreys County, Tennessee","574","896","517","72","2249","2059","190","1613","446","2249","42909","47","085","47085","2010"
"Census Tract 1302, Humphreys County, Tennessee","339","374","167","11","1181","891","290","747","144","1181","32839","47","085","47085","2010"
"Census Tract 1303, Humphreys County, Tennessee","847","958","592","95","2831","2492","339","1685","807","2831","39960","47","085","47085","2010"
"Census Tract 1304, Humphreys County, Tennessee","350","337","245","30","1266","962","304","766","196","1266","36176","47","085","47085","2010"
"Census Tract 1305, Humphreys County, Tennessee","373","417","309","52","1351","1151","200","897","254","1351","48403","47","085","47085","2010"
"Census Tract 9601, Jackson County, Tennessee","345","254","195","30","1086","824","262","618","206","1086","32578","47","087","47087","2010"
"Census Tract 9602, Jackson County, Tennessee","380","341","171","21","1168","913","255","731","182","1168","28512","47","087","47087","2010"
"Census Tract 9603, Jackson County, Tennessee","969","725","353","100","2615","2147","468","1690","457","2615","33692","47","087","47087","2010"
"Census Tract 9604, Jackson County, Tennessee","320","197","230","17","899","764","135","508","256","899","36786","47","087","47087","2010"
"Census Tract 701, Jefferson County, Tennessee","924","949","683","214","3151","2770","381","2128","642","3151","35203","47","089","47089","2010"
"Census Tract 702, Jefferson County, Tennessee","621","668","399","197","2068","1885","183","1470","415","2068","37327","47","089","47089","2010"
"Census Tract 703, Jefferson County, Tennessee","837","1077","497","102","2858","2513","345","1294","1219","2858","31335","47","089","47089","2010"
"Census Tract 704, Jefferson County, Tennessee","520","536","390","78","1704","1524","180","1131","393","1704","35636","47","089","47089","2010"
"Census Tract 705, Jefferson County, Tennessee","575","705","642","124","2366","2046","320","1606","440","2366","40321","47","089","47089","2010"
"Census Tract 706, Jefferson County, Tennessee","723","584","584","61","2067","1952","115","1314","638","2067","37324","47","089","47089","2010"
"Census Tract 707, Jefferson County, Tennessee","784","888","705","156","3014","2533","481","2049","484","3014","47234","47","089","47089","2010"
"Census Tract 708, Jefferson County, Tennessee","905","845","738","106","3175","2594","581","2201","393","3175","37500","47","089","47089","2010"
"Census Tract 709, Jefferson County, Tennessee","546","730","436","68","2626","1780","846","1470","310","2626","44722","47","089","47089","2010"
"Census Tract 9560, Johnson County, Tennessee","246","158","36","0","522","440","82","400","40","522","31000","47","091","47091","2010"
"Census Tract 9561, Johnson County, Tennessee","419","632","272","0","1410","1323","87","1006","317","1410","31364","47","091","47091","2010"
"Census Tract 9562, Johnson County, Tennessee","360","454","228","17","1383","1059","324","885","174","1383","29142","47","091","47091","2010"
"Census Tract 9563, Johnson County, Tennessee","1090","884","522","57","3070","2553","517","1731","822","3070","26317","47","091","47091","2010"
"Census Tract 9564, Johnson County, Tennessee","789","748","460","4","2489","2001","488","1613","388","2489","30164","47","091","47091","2010"
"Census Tract 1, Knox County, Tennessee","439","540","56","0","1143","1035","108","166","869","1143","24413","47","093","47093","2010"
"Census Tract 8, Knox County, Tennessee","541","773","232","56","1777","1602","175","321","1281","1777","18511","47","093","47093","2010"
"Census Tract 9.01, Knox County, Tennessee","10","0","0","0","10","10","0","0","10","10","2499","47","093","47093","2010"
"Census Tract 9.02, Knox County, Tennessee","71","199","0","9","297","279","18","0","279","297","7545","47","093","47093","2010"
"Census Tract 14, Knox County, Tennessee","696","335","89","25","1500","1145","355","371","774","1500","12020","47","093","47093","2010"
"Census Tract 15, Knox County, Tennessee","632","692","205","37","1681","1566","115","1027","539","1681","30577","47","093","47093","2010"
"Census Tract 16, Knox County, Tennessee","581","609","322","0","1708","1512","196","809","703","1708","30526","47","093","47093","2010"
"Census Tract 17, Knox County, Tennessee","618","420","182","26","1461","1246","215","753","493","1461","24727","47","093","47093","2010"
"Census Tract 18, Knox County, Tennessee","367","403","314","39","1158","1123","35","848","275","1158","38047","47","093","47093","2010"
"Census Tract 19, Knox County, Tennessee","392","306","77","0","959","775","184","414","361","959","27004","47","093","47093","2010"
"Census Tract 20, Knox County, Tennessee","661","631","156","20","1634","1468","166","786","682","1634","24863","47","093","47093","2010"
"Census Tract 21, Knox County, Tennessee","628","499","63","51","1290","1241","49","728","513","1290","30991","47","093","47093","2010"
"Census Tract 22, Knox County, Tennessee","599","768","407","10","1864","1784","80","1283","501","1864","31748","47","093","47093","2010"
"Census Tract 23, Knox County, Tennessee","483","799","317","0","1832","1599","233","865","734","1832","26583","47","093","47093","2010"
"Census Tract 24, Knox County, Tennessee","623","674","297","92","2050","1686","364","876","810","2050","25180","47","093","47093","2010"
"Census Tract 26, Knox County, Tennessee","349","403","210","51","1247","1013","234","215","798","1247","22451","47","093","47093","2010"
"Census Tract 27, Knox County, Tennessee","510","474","222","0","1269","1206","63","831","375","1269","25658","47","093","47093","2010"
"Census Tract 28, Knox County, Tennessee","674","955","317","54","2303","2000","303","592","1408","2303","24524","47","093","47093","2010"
"Census Tract 29, Knox County, Tennessee","698","823","172","17","1856","1710","146","676","1034","1856","21608","47","093","47093","2010"
"Census Tract 30, Knox County, Tennessee","618","1256","602","35","2749","2511","238","1367","1144","2749","36628","47","093","47093","2010"
"Census Tract 31, Knox County, Tennessee","337","482","349","60","1256","1228","28","1038","190","1256","45750","47","093","47093","2010"
"Census Tract 32, Knox County, Tennessee","434","843","190","85","1710","1552","158","777","775","1710","33568","47","093","47093","2010"
"Census Tract 33, Knox County, Tennessee","318","204","305","95","929","922","7","862","60","929","79348","47","093","47093","2010"
"Census Tract 34, Knox County, Tennessee","553","817","424","52","2059","1846","213","1436","410","2059","36786","47","093","47093","2010"
"Census Tract 35, Knox County, Tennessee","640","699","461","70","2106","1870","236","1273","597","2106","45000","47","093","47093","2010"
"Census Tract 37, Knox County, Tennessee","577","933","443","61","2325","2014","311","428","1586","2325","23013","47","093","47093","2010"
"Census Tract 38.01, Knox County, Tennessee","313","1043","559","99","2199","2014","185","590","1424","2199","36627","47","093","47093","2010"
"Census Tract 38.02, Knox County, Tennessee","170","518","630","3","1404","1321","83","958","363","1404","48438","47","093","47093","2010"
"Census Tract 39.01, Knox County, Tennessee","568","769","396","105","1851","1838","13","1222","616","1851","40000","47","093","47093","2010"
"Census Tract 39.02, Knox County, Tennessee","204","928","255","0","1443","1387","56","784","603","1443","32011","47","093","47093","2010"
"Census Tract 40, Knox County, Tennessee","552","1298","432","0","2599","2282","317","1179","1103","2599","29256","47","093","47093","2010"
"Census Tract 41, Knox County, Tennessee","493","907","583","48","2170","2031","139","1297","734","2170","38378","47","093","47093","2010"
"Census Tract 42, Knox County, Tennessee","408","634","433","69","1695","1544","151","953","591","1695","48114","47","093","47093","2010"
"Census Tract 43, Knox County, Tennessee","272","513","363","29","1275","1177","98","720","457","1275","36431","47","093","47093","2010"
"Census Tract 44.01, Knox County, Tennessee","376","835","613","39","2105","1863","242","1657","206","2105","74698","47","093","47093","2010"
"Census Tract 44.03, Knox County, Tennessee","941","921","504","26","2762","2392","370","878","1514","2762","31806","47","093","47093","2010"
"Census Tract 44.04, Knox County, Tennessee","386","798","459","24","1907","1667","240","621","1046","1907","39219","47","093","47093","2010"
"Census Tract 45, Knox County, Tennessee","615","1375","689","77","3052","2756","296","1234","1522","3052","49708","47","093","47093","2010"
"Census Tract 46.06, Knox County, Tennessee","487","784","1011","167","2520","2449","71","2183","266","2520","76279","47","093","47093","2010"
"Census Tract 46.07, Knox County, Tennessee","295","827","980","65","2231","2167","64","1806","361","2231","61663","47","093","47093","2010"
"Census Tract 46.08, Knox County, Tennessee","156","629","425","56","1266","1266","0","1149","117","1266","49250","47","093","47093","2010"
"Census Tract 46.09, Knox County, Tennessee","387","1161","553","74","2511","2175","336","1194","981","2511","50865","47","093","47093","2010"
"Census Tract 9504, Wayne County, Tennessee","463","364","330","100","1508","1257","251","1165","92","1508","38320","47","181","47181","2010"
"Census Tract 9680, Weakley County, Tennessee","199","256","147","10","643","612","31","491","121","643","38750","47","183","47183","2010"
"Census Tract 9681.01, Weakley County, Tennessee","541","662","354","35","1748","1592","156","748","844","1748","25296","47","183","47183","2010"
"Census Tract 9681.02, Weakley County, Tennessee","178","365","276","30","892","849","43","678","171","892","49031","47","183","47183","2010"
"Census Tract 9682.01, Weakley County, Tennessee","550","693","605","50","2060","1898","162","1517","381","2060","47841","47","183","47183","2010"
"Census Tract 9682.02, Weakley County, Tennessee","172","125","8","0","387","305","82","28","277","387","14839","47","183","47183","2010"
"Census Tract 9682.03, Weakley County, Tennessee","421","588","400","62","1582","1471","111","494","977","1582","20080","47","183","47183","2010"
"Census Tract 9683, Weakley County, Tennessee","391","295","251","22","1075","959","116","653","306","1075","37694","47","183","47183","2010"
"Census Tract 9684, Weakley County, Tennessee","811","671","483","122","2459","2087","372","1450","637","2459","31875","47","183","47183","2010"
"Census Tract 9685, Weakley County, Tennessee","720","557","531","80","2159","1888","271","1396","492","2159","30924","47","183","47183","2010"
"Census Tract 9686, Weakley County, Tennessee","546","602","266","107","1785","1521","264","1175","346","1785","28984","47","183","47183","2010"
"Census Tract 9687, Weakley County, Tennessee","235","228","124","12","696","599","97","484","115","696","30685","47","183","47183","2010"
"Census Tract 9350, White County, Tennessee","598","510","403","60","1800","1571","229","1348","223","1800","33839","47","185","47185","2010"
"Census Tract 9351, White County, Tennessee","500","714","630","111","2141","1955","186","1483","472","2141","38338","47","185","47185","2010"
"Census Tract 9352, White County, Tennessee","413","619","443","23","1706","1498","208","1196","302","1706","32500","47","185","47185","2010"
"Census Tract 9353, White County, Tennessee","645","811","420","67","2328","1943","385","1523","420","2328","36678","47","185","47185","2010"
"Census Tract 9354, White County, Tennessee","706","518","290","21","1803","1535","268","866","669","1803","24283","47","185","47185","2010"
"Census Tract 9355, White County, Tennessee","402","498","340","85","1548","1325","223","1110","215","1548","37607","47","185","47185","2010"
"Census Tract 501.01, Williamson County, Tennessee","230","729","849","120","2058","1928","130","1783","145","2058","113534","47","187","47187","2010"
"Census Tract 501.02, Williamson County, Tennessee","170","441","486","78","1211","1175","36","1109","66","1211","90114","47","187","47187","2010"
"Census Tract 501.03, Williamson County, Tennessee","386","572","446","80","1638","1484","154","1311","173","1638","65758","47","187","47187","2010"
"Census Tract 502.03, Williamson County, Tennessee","309","724","565","78","1714","1676","38","1555","121","1714","149914","47","187","47187","2010"
"Census Tract 502.04, Williamson County, Tennessee","104","601","693","101","1553","1499","54","1499","0","1553","149219","47","187","47187","2010"
"Census Tract 502.05, Williamson County, Tennessee","237","429","446","52","1164","1164","0","1116","48","1164","101250","47","187","47187","2010"
"Census Tract 502.06, Williamson County, Tennessee","28","435","402","27","892","892","0","873","19","892","168456","47","187","47187","2010"
"Census Tract 502.07, Williamson County, Tennessee","134","549","289","48","1032","1020","12","1020","0","1032","179118","47","187","47187","2010"
"Census Tract 502.08, Williamson County, Tennessee","271","1197","747","141","2428","2356","72","1147","1209","2428","101471","47","187","47187","2010"
"Census Tract 503.03, Williamson County, Tennessee","205","401","314","49","1008","969","39","932","37","1008","137176","47","187","47187","2010"
"Census Tract 503.04, Williamson County, Tennessee","284","245","154","51","805","734","71","650","84","805","103590","47","187","47187","2010"
"Census Tract 503.05, Williamson County, Tennessee","170","308","266","39","846","783","63","717","66","846","169554","47","187","47187","2010"
"Census Tract 503.06, Williamson County, Tennessee","208","236","159","39","671","642","29","539","103","671","67500","47","187","47187","2010"
"Census Tract 503.07, Williamson County, Tennessee","475","759","429","45","1826","1708","118","850","858","1826","60500","47","187","47187","2010"
"Census Tract 504.03, Williamson County, Tennessee","96","327","264","33","720","720","0","670","50","720","101250","47","187","47187","2010"
"Census Tract 504.04, Williamson County, Tennessee","374","949","799","91","2302","2213","89","2145","68","2302","150932","47","187","47187","2010"
"Census Tract 504.05, Williamson County, Tennessee","156","352","338","43","924","889","35","875","14","924","131016","47","187","47187","2010"
"Census Tract 504.06, Williamson County, Tennessee","184","640","689","123","1675","1636","39","1546","90","1675","128500","47","187","47187","2010"
"Census Tract 505.02, Williamson County, Tennessee","409","589","445","68","1681","1511","170","1310","201","1681","54803","47","187","47187","2010"
"Census Tract 505.03, Williamson County, Tennessee","327","538","669","125","1755","1659","96","1462","197","1755","61632","47","187","47187","2010"
"Census Tract 505.04, Williamson County, Tennessee","317","443","501","49","1408","1310","98","821","489","1408","51615","47","187","47187","2010"
"Census Tract 506.01, Williamson County, Tennessee","267","822","842","199","2168","2130","38","1396","734","2168","75387","47","187","47187","2010"
"Census Tract 506.02, Williamson County, Tennessee","591","1025","1104","130","3009","2850","159","2572","278","3009","78068","47","187","47187","2010"
"Census Tract 507.01, Williamson County, Tennessee","115","609","727","81","1657","1532","125","1322","210","1657","85000","47","187","47187","2010"
"Census Tract 507.02, Williamson County, Tennessee","266","694","365","76","1418","1401","17","1320","81","1418","132599","47","187","47187","2010"
"Census Tract 508, Williamson County, Tennessee","640","997","541","141","2577","2319","258","1477","842","2577","41048","47","187","47187","2010"
"Census Tract 509.04, Williamson County, Tennessee","320","713","629","126","1946","1788","158","898","890","1946","51293","47","187","47187","2010"
"Census Tract 509.05, Williamson County, Tennessee","443","827","782","187","2371","2239","132","1266","973","2371","70120","47","187","47187","2010"
"Census Tract 509.06, Williamson County, Tennessee","325","786","644","166","1987","1921","66","1696","225","1987","91214","47","187","47187","2010"
"Census Tract 509.07, Williamson County, Tennessee","433","706","640","148","2057","1927","130","1448","479","2057","79485","47","187","47187","2010"
"Census Tract 509.08, Williamson County, Tennessee","184","440","544","64","1247","1232","15","1188","44","1247","102381","47","187","47187","2010"
"Census Tract 509.09, Williamson County, Tennessee","154","400","523","114","1221","1191","30","1131","60","1221","124609","47","187","47187","2010"
"Census Tract 510.01, Williamson County, Tennessee","217","811","685","61","1817","1774","43","1762","12","1817","120625","47","187","47187","2010"
"Census Tract 510.02, Williamson County, Tennessee","332","732","895","164","2214","2123","91","1534","589","2214","87679","47","187","47187","2010"
"Census Tract 511.00, Williamson County, Tennessee","492","556","808","185","2350","2041","309","1687","354","2350","65107","47","187","47187","2010"
"Census Tract 512.01, Williamson County, Tennessee","393","777","594","115","2095","1879","216","1578","301","2095","73542","47","187","47187","2010"
"Census Tract 512.02, Williamson County, Tennessee","686","2476","2639","392","6458","6193","265","5590","603","6458","78059","47","187","47187","2010"
"Census Tract 301.01, Wilson County, Tennessee","547","1112","1040","188","3023","2887","136","2399","488","3023","60874","47","189","47189","2010"
"Census Tract 301.02, Wilson County, Tennessee","412","880","927","248","2683","2467","216","2290","177","2683","60296","47","189","47189","2010"
"Census Tract 302.02, Wilson County, Tennessee","425","813","668","92","2035","1998","37","1846","152","2035","78000","47","189","47189","2010"
"Census Tract 302.03, Wilson County, Tennessee","149","566","668","97","1526","1480","46","1411","69","1526","86899","47","189","47189","2010"
"Census Tract 302.04, Wilson County, Tennessee","428","999","629","102","2403","2158","245","1915","243","2403","68019","47","189","47189","2010"
"Census Tract 303.03, Wilson County, Tennessee","287","601","661","67","1693","1616","77","1520","96","1693","86667","47","189","47189","2010"
"Census Tract 303.04, Wilson County, Tennessee","440","860","817","270","2453","2387","66","2215","172","2453","57554","47","189","47189","2010"
"Census Tract 303.05, Wilson County, Tennessee","390","860","775","151","2176","2176","0","2021","155","2176","76658","47","189","47189","2010"
"Census Tract 303.07, Wilson County, Tennessee","597","887","844","156","2649","2484","165","2154","330","2649","68191","47","189","47189","2010"
"Census Tract 303.08, Wilson County, Tennessee","110","386","820","112","1531","1428","103","1341","87","1531","94762","47","189","47189","2010"
"Census Tract 303.09, Wilson County, Tennessee","185","815","662","99","1813","1761","52","1449","312","1813","77799","47","189","47189","2010"
"Census Tract 304.01, Wilson County, Tennessee","293","319","215","71","943","898","45","528","370","943","33264","47","189","47189","2010"
"Census Tract 304.02, Wilson County, Tennessee","376","657","277","88","1681","1398","283","640","758","1681","38357","47","189","47189","2010"
"Census Tract 305, Wilson County, Tennessee","615","1028","695","85","2676","2423","253","1258","1165","2676","40201","47","189","47189","2010"
"Census Tract 306, Wilson County, Tennessee","492","605","417","68","1725","1582","143","929","653","1725","43361","47","189","47189","2010"
"Census Tract 307, Wilson County, Tennessee","408","475","164","52","1217","1099","118","486","613","1217","31467","47","189","47189","2010"
"Census Tract 308, Wilson County, Tennessee","439","765","724","148","2370","2076","294","1841","235","2370","62903","47","189","47189","2010"
"Census Tract 309.01, Wilson County, Tennessee","537","1239","1179","179","3164","3134","30","2510","624","3164","63084","47","189","47189","2010"
"Census Tract 309.03, Wilson County, Tennessee","405","720","892","105","2197","2122","75","1804","318","2197","66875","47","189","47189","2010"
"Census Tract 309.04, Wilson County, Tennessee","263","609","453","40","1466","1365","101","1292","73","1466","56636","47","189","47189","2010"
"Census Tract 310, Wilson County, Tennessee","787","766","674","55","2536","2282","254","1956","326","2536","44906","47","189","47189","2010"
"Census Tract 9751, Rhea County, Tennessee","617","882","366","49","2300","1914","386","1525","389","2300","37213","47","143","47143","2010"
"Census Tract 9752, Rhea County, Tennessee","697","861","585","156","2462","2299","163","1824","475","2462","38085","47","143","47143","2010"
"Census Tract 9753, Rhea County, Tennessee","613","848","527","43","2372","2031","341","1724","307","2372","34916","47","143","47143","2010"
"Census Tract 9754.01, Rhea County, Tennessee","1035","712","370","107","2693","2224","469","1096","1128","2693","31000","47","143","47143","2010"
"Census Tract 9754.02, Rhea County, Tennessee","259","599","338","67","1370","1263","107","974","289","1370","42367","47","143","47143","2010"
"Census Tract 301, Roane County, Tennessee","341","467","469","55","1368","1332","36","1205","127","1368","92000","47","145","47145","2010"
"Census Tract 302.01, Roane County, Tennessee","846","1024","793","81","2964","2744","220","2249","495","2964","49231","47","145","47145","2010"
"Census Tract 302.02, Roane County, Tennessee","1065","1080","800","95","3202","3040","162","2195","845","3202","48125","47","145","47145","2010"
"Census Tract 303, Roane County, Tennessee","941","1140","640","182","3372","2903","469","2360","543","3372","39896","47","145","47145","2010"
"Census Tract 304, Roane County, Tennessee","1073","931","593","74","2974","2671","303","2209","462","2974","41526","47","145","47145","2010"
"Census Tract 305, Roane County, Tennessee","795","551","231","53","1836","1630","206","1022","608","1836","25151","47","145","47145","2010"
"Census Tract 306, Roane County, Tennessee","432","616","375","82","1686","1505","181","1184","321","1686","47743","47","145","47145","2010"
"Census Tract 307, Roane County, Tennessee","671","835","441","76","2362","2023","339","1497","526","2362","35338","47","145","47145","2010"
"Census Tract 308, Roane County, Tennessee","1135","689","480","105","3038","2409","629","1510","899","3038","30276","47","145","47145","2010"
"Census Tract 309, Roane County, Tennessee","764","853","653","45","2612","2315","297","1936","379","2612","42981","47","145","47145","2010"
"Census Tract 9801, Roane County, Tennessee","0","0","0","0","0","0","0","0","0","0","-666666666","47","145","47145","2010"
"Census Tract 801.01, Robertson County, Tennessee","404","580","369","83","1528","1436","92","1141","295","1528","47692","47","147","47147","2010"
"Census Tract 801.03, Robertson County, Tennessee","423","633","984","49","2144","2089","55","1786","303","2144","65439","47","147","47147","2010"
"Census Tract 801.04, Robertson County, Tennessee","596","985","717","100","2508","2398","110","2063","335","2508","50123","47","147","47147","2010"
"Census Tract 802, Robertson County, Tennessee","450","681","707","211","2251","2049","202","1656","393","2251","53985","47","147","47147","2010"
"Census Tract 803.01, Robertson County, Tennessee","307","423","272","118","1165","1120","45","674","446","1165","44022","47","147","47147","2010"
"Census Tract 803.02, Robertson County, Tennessee","314","506","190","104","1400","1114","286","580","534","1400","33929","47","147","47147","2010"
"Census Tract 804.01, Robertson County, Tennessee","441","708","443","89","1914","1681","233","776","905","1914","31250","47","147","47147","2010"
"Census Tract 804.02, Robertson County, Tennessee","563","655","407","72","1909","1697","212","1109","588","1909","36734","47","147","47147","2010"
"Census Tract 805, Robertson County, Tennessee","267","444","456","215","1556","1382","174","1293","89","1556","63417","47","147","47147","2010"
"Census Tract 806.03, Robertson County, Tennessee","375","435","587","189","1602","1586","16","1352","234","1602","59605","47","147","47147","2010"
"Census Tract 806.04, Robertson County, Tennessee","267","631","430","48","1376","1376","0","1151","225","1376","53848","47","147","47147","2010"
"Census Tract 806.05, Robertson County, Tennessee","153","482","307","154","1157","1096","61","932","164","1157","56228","47","147","47147","2010"
"Census Tract 806.06, Robertson County, Tennessee","544","614","787","166","2301","2111","190","1542","569","2301","50774","47","147","47147","2010"
"Census Tract 807, Robertson County, Tennessee","588","1133","827","110","2796","2658","138","2384","274","2796","60877","47","147","47147","2010"
"Census Tract 401.01, Rutherford County, Tennessee","93","572","372","53","1090","1090","0","924","166","1090","56379","47","149","47149","2010"
"Census Tract 401.02, Rutherford County, Tennessee","205","479","377","115","1247","1176","71","964","212","1247","58111","47","149","47149","2010"
"Census Tract 401.03, Rutherford County, Tennessee","228","985","661","103","2219","1977","242","1519","458","2219","54181","47","149","47149","2010"
"Census Tract 401.04, Rutherford County, Tennessee","378","758","444","113","1805","1693","112","1218","475","1805","40828","47","149","47149","2010"
"Census Tract 401.05, Rutherford County, Tennessee","189","736","401","99","1564","1425","139","1129","296","1564","53899","47","149","47149","2010"
"Census Tract 402, Rutherford County, Tennessee","205","404","508","121","1343","1238","105","1074","164","1343","60263","47","149","47149","2010"
"Census Tract 403.02, Rutherford County, Tennessee","403","1256","1030","287","3084","2976","108","2381","595","3084","55764","47","149","47149","2010"
"Census Tract 403.03, Rutherford County, Tennessee","218","339","246","67","905","870","35","454","416","905","36583","47","149","47149","2010"
"Census Tract 403.04, Rutherford County, Tennessee","154","429","270","17","962","870","92","715","155","962","51974","47","149","47149","2010"
"Census Tract 403.05, Rutherford County, Tennessee","436","529","161","0","1126","1126","0","504","622","1126","26044","47","149","47149","2010"
"Census Tract 403.06, Rutherford County, Tennessee","212","882","554","35","1872","1683","189","718","965","1872","42355","47","149","47149","2010"
"Census Tract 403.07, Rutherford County, Tennessee","156","284","470","119","1029","1029","0","1001","28","1029","93316","47","149","47149","2010"
"Census Tract 403.08, Rutherford County, Tennessee","193","956","816","79","2200","2044","156","1590","454","2200","55670","47","149","47149","2010"
"Census Tract 404.03, Rutherford County, Tennessee","699","947","862","148","2949","2656","293","1556","1100","2949","47372","47","149","47149","2010"
"Census Tract 405.01, Rutherford County, Tennessee","356","741","921","182","2293","2200","93","2043","157","2293","74045","47","149","47149","2010"
"Census Tract 405.02, Rutherford County, Tennessee","580","869","852","163","2581","2464","117","2082","382","2581","57462","47","149","47149","2010"
"Census Tract 406, Rutherford County, Tennessee","389","690","376","92","1871","1547","324","1172","375","1871","44122","47","149","47149","2010"
"Census Tract 407.01, Rutherford County, Tennessee","240","1106","1385","136","3063","2867","196","2423","444","3063","64904","47","149","47149","2010"
"Census Tract 407.02, Rutherford County, Tennessee","197","770","573","96","1766","1636","130","1456","180","1766","58083","47","149","47149","2010"
"Census Tract 408.05, Rutherford County, Tennessee","366","902","1089","264","2749","2621","128","2286","335","2749","81073","47","149","47149","2010"
"Census Tract 408.06, Rutherford County, Tennessee","360","696","933","217","2228","2206","22","2075","131","2228","68566","47","149","47149","2010"
"Census Tract 408.07, Rutherford County, Tennessee","219","658","501","147","1653","1525","128","1349","176","1653","67083","47","149","47149","2010"
"Census Tract 408.08, Rutherford County, Tennessee","281","564","865","178","2127","1888","239","1724","164","2127","89808","47","149","47149","2010"
"Census Tract 408.09, Rutherford County, Tennessee","258","399","544","47","1248","1248","0","1040","208","1248","53071","47","149","47149","2010"
"Census Tract 408.10, Rutherford County, Tennessee","213","301","275","18","933","807","126","623","184","933","59275","47","149","47149","2010"
"Census Tract 409.01, Rutherford County, Tennessee","162","609","258","48","1113","1077","36","707","370","1113","46101","47","149","47149","2010"
"Census Tract 409.02, Rutherford County, Tennessee","338","1062","1024","227","2651","2651","0","1629","1022","2651","63352","47","149","47149","2010"
"Census Tract 409.03, Rutherford County, Tennessee","261","1421","1448","231","3676","3361","315","2162","1199","3676","59609","47","149","47149","2010"
"Census Tract 409.04, Rutherford County, Tennessee","205","738","603","179","1777","1725","52","1449","276","1777","68608","47","149","47149","2010"
"Census Tract 409.05, Rutherford County, Tennessee","487","1153","993","125","3030","2758","272","1893","865","3030","60258","47","149","47149","2010"
"Census Tract 410, Rutherford County, Tennessee","440","1215","697","149","2568","2501","67","2097","404","2568","57529","47","149","47149","2010"
"Census Tract 411.01, Rutherford County, Tennessee","357","1077","822","260","2615","2516","99","2199","317","2615","74746","47","149","47149","2010"
"Census Tract 411.02, Rutherford County, Tennessee","343","518","322","40","1316","1223","93","874","349","1316","43447","47","149","47149","2010"
"Census Tract 412.01, Rutherford County, Tennessee","311","557","646","174","1776","1688","88","1575","113","1776","80714","47","149","47149","2010"
"Census Tract 412.02, Rutherford County, Tennessee","184","521","635","39","1430","1379","51","1293","86","1430","53268","47","149","47149","2010"
"Census Tract 413.01, Rutherford County, Tennessee","409","682","582","193","1917","1866","51","1705","161","1917","108482","47","149","47149","2010"
"Census Tract 413.02, Rutherford County, Tennessee","565","947","811","63","2433","2386","47","1850","536","2433","64792","47","149","47149","2010"
"Census Tract 414.01, Rutherford County, Tennessee","337","711","382","86","1612","1516","96","829","687","1612","39683","47","149","47149","2010"
"Census Tract 414.02, Rutherford County, Tennessee","757","1273","554","21","3020","2605","415","586","2019","3020","30230","47","149","47149","2010"
"Census Tract 414.03, Rutherford County, Tennessee","557","1215","844","222","3100","2838","262","1123","1715","3100","38636","47","149","47149","2010"
"Census Tract 415, Rutherford County, Tennessee","0","92","0","0","92","92","0","0","92","92","7125","47","149","47149","2010"
"Census Tract 416, Rutherford County, Tennessee","909","1275","679","35","3169","2898","271","514","2384","3169","22169","47","149","47149","2010"
"Census Tract 417, Rutherford County, Tennessee","618","862","845","65","2502","2390","112","1030","1360","2502","42079","47","149","47149","2010"
"Census Tract 418, Rutherford County, Tennessee","372","636","216","72","1537","1296","241","405","891","1537","32885","47","149","47149","2010"
"Census Tract 419, Rutherford County, Tennessee","565","668","283","53","2001","1569","432","340","1229","2001","23865","47","149","47149","2010"
"Census Tract 420, Rutherford County, Tennessee","407","772","444","237","2245","1860","385","1087","773","2245","44727","47","149","47149","2010"
"Census Tract 421, Rutherford County, Tennessee","623","1519","975","177","3674","3294","380","1546","1748","3674","34235","47","149","47149","2010"
"Census Tract 422, Rutherford County, Tennessee","479","679","598","81","1910","1837","73","1084","753","1910","48135","47","149","47149","2010"
"Census Tract 423.00, Rutherford County, Tennessee","281","742","977","155","2436","2155","281","1742","413","2436","58671","47","149","47149","2010"
"Census Tract 9750, Scott County, Tennessee","693","643","293","10","1810","1639","171","1366","273","1810","24982","47","151","47151","2010"
"Census Tract 9751, Scott County, Tennessee","1101","1008","628","43","3194","2780","414","1913","867","3194","28263","47","151","47151","2010"
"Census Tract 9752, Scott County, Tennessee","674","777","595","50","2412","2096","316","1449","647","2412","32374","47","151","47151","2010"
"Census Tract 9753, Scott County, Tennessee","437","391","221","27","1148","1076","72","814","262","1148","29688","47","151","47151","2010"
"Census Tract 9754, Scott County, Tennessee","377","426","169","54","1226","1026","200","837","189","1226","24933","47","151","47151","2010"
"Census Tract 601.01, Sequatchie County, Tennessee","978","1240","663","87","3515","2968","547","2231","737","3515","31829","47","153","47153","2010"
"Census Tract 601.02, Sequatchie County, Tennessee","340","143","91","32","832","606","226","557","49","832","38143","47","153","47153","2010"
"Census Tract 602, Sequatchie County, Tennessee","559","594","332","24","1755","1509","246","1167","342","1755","34419","47","153","47153","2010"
"Census Tract 801.01, Sevier County, Tennessee","383","623","534","110","1773","1650","123","1272","378","1773","50861","47","155","47155","2010"
"Census Tract 801.02, Sevier County, Tennessee","544","1094","933","157","3191","2728","463","2053","675","3191","50000","47","155","47155","2010"
"Census Tract 802.01, Sevier County, Tennessee","736","946","972","239","3134","2893","241","2440","453","3134","51942","47","155","47155","2010"
"Census Tract 802.02, Sevier County, Tennessee","512","761","483","177","2177","1933","244","1689","244","2177","47228","47","155","47155","2010"
"Census Tract 803, Sevier County, Tennessee","422","894","773","146","2558","2235","323","1401","834","2558","47929","47","155","47155","2010"
"Census Tract 804, Sevier County, Tennessee","739","1060","719","303","3713","2821","892","1933","888","3713","39408","47","155","47155","2010"
"Census Tract 805, Sevier County, Tennessee","788","859","743","112","3037","2502","535","1218","1284","3037","27532","47","155","47155","2010"
"Census Tract 806.01, Sevier County, Tennessee","581","844","377","110","2145","1912","233","1071","841","2145","31441","47","155","47155","2010"
"Census Tract 806.02, Sevier County, Tennessee","762","1060","1252","453","4137","3527","610","2806","721","4137","43845","47","155","47155","2010"
"Census Tract 807.00, Sevier County, Tennessee","897","1026","880","148","4437","2951","1486","2277","674","4437","42002","47","155","47155","2010"
"Census Tract 808.01, Sevier County, Tennessee","210","425","396","87","1457","1118","339","381","737","1457","31935","47","155","47155","2010"
"Census Tract 808.02, Sevier County, Tennessee","707","1248","923","55","3399","2933","466","1882","1051","3399","43775","47","155","47155","2010"
"Census Tract 809.01, Sevier County, Tennessee","450","456","343","121","2901","1370","1531","1050","320","2901","41667","47","155","47155","2010"
"Census Tract 809.02, Sevier County, Tennessee","521","814","517","109","3029","1961","1068","1288","673","3029","37554","47","155","47155","2010"
"Census Tract 810, Sevier County, Tennessee","561","1068","628","240","4254","2497","1757","1338","1159","4254","32169","47","155","47155","2010"
"Census Tract 811.01, Sevier County, Tennessee","262","357","115","83","3935","817","3118","430","387","3935","35208","47","155","47155","2010"
"Census Tract 811.02, Sevier County, Tennessee","468","367","646","254","3490","1735","1755","1284","451","3490","48431","47","155","47155","2010"
"Census Tract 9801, Sevier County, Tennessee","0","0","0","0","0","0","0","0","0","0","-666666666","47","155","47155","2010"
"Census Tract 1, Shelby County, Tennessee","411","1742","770","105","3261","3028","233","1160","1868","3261","70437","47","157","47157","2010"
"Census Tract 2, Shelby County, Tennessee","40","262","25","0","530","327","203","78","249","530","28352","47","157","47157","2010"
"Census Tract 3, Shelby County, Tennessee","201","145","26","57","494","429","65","271","158","494","17123","47","157","47157","2010"
"Census Tract 4, Shelby County, Tennessee","316","146","152","0","894","614","280","298","316","894","16351","47","157","47157","2010"
"Census Tract 6, Shelby County, Tennessee","420","458","44","21","1220","943","277","538","405","1220","21472","47","157","47157","2010"
"Census Tract 7, Shelby County, Tennessee","816","796","354","0","2603","1966","637","852","1114","2603","25921","47","157","47157","2010"
"Census Tract 8, Shelby County, Tennessee","658","301","57","14","1279","1030","249","430","600","1279","12944","47","157","47157","2010"
"Census Tract 9, Shelby County, Tennessee","439","517","184","10","1524","1150","374","502","648","1524","18333","47","157","47157","2010"
"Census Tract 11, Shelby County, Tennessee","374","609","299","22","1550","1304","246","565","739","1550","28768","47","157","47157","2010"
"Census Tract 12, Shelby County, Tennessee","287","755","320","89","1726","1451","275","753","698","1726","33875","47","157","47157","2010"
"Census Tract 13, Shelby County, Tennessee","398","548","184","54","1719","1184","535","650","534","1719","26091","47","157","47157","2010"
"Census Tract 14, Shelby County, Tennessee","240","370","20","0","793","630","163","233","397","793","19313","47","157","47157","2010"
"Census Tract 15, Shelby County, Tennessee","397","284","66","34","951","781","170","410","371","951","18699","47","157","47157","2010"
"Census Tract 16, Shelby County, Tennessee","252","448","235","39","1087","974","113","782","192","1087","66894","47","157","47157","2010"
"Census Tract 17, Shelby County, Tennessee","434","729","260","50","2012","1473","539","1111","362","2012","42428","47","157","47157","2010"
"Census Tract 19, Shelby County, Tennessee","435","169","50","8","872","662","210","312","350","872","11701","47","157","47157","2010"
"Census Tract 20, Shelby County, Tennessee","225","259","127","0","725","611","114","284","327","725","26797","47","157","47157","2010"
"Census Tract 21, Shelby County, Tennessee","202","121","46","6","456","375","81","111","264","456","15288","47","157","47157","2010"
"Census Tract 24, Shelby County, Tennessee","265","231","73","8","987","577","410","186","391","987","17077","47","157","47157","2010"
"Census Tract 25, Shelby County, Tennessee","184","539","394","17","1390","1134","256","667","467","1390","43750","47","157","47157","2010"
"Census Tract 26, Shelby County, Tennessee","77","700","354","32","1257","1163","94","675","488","1257","58073","47","157","47157","2010"
"Census Tract 27, Shelby County, Tennessee","189","380","165","75","955","809","146","259","550","955","29250","47","157","47157","2010"
"Census Tract 28, Shelby County, Tennessee","769","674","149","2","1950","1594","356","519","1075","1950","19815","47","157","47157","2010"
"Census Tract 29, Shelby County, Tennessee","384","1127","644","0","2412","2155","257","1734","421","2412","75151","47","157","47157","2010"
"Census Tract 30, Shelby County, Tennessee","481","545","148","45","1526","1219","307","482","737","1526","32126","47","157","47157","2010"
"Census Tract 31, Shelby County, Tennessee","462","718","526","64","1924","1770","154","877","893","1924","42436","47","157","47157","2010"
"Census Tract 32, Shelby County, Tennessee","753","1195","257","15","2510","2220","290","548","1672","2510","31000","47","157","47157","2010"
"Census Tract 33, Shelby County, Tennessee","145","631","362","10","1194","1148","46","706","442","1194","66111","47","157","47157","2010"
"Census Tract 34, Shelby County, Tennessee","195","618","301","0","1402","1114","288","341","773","1402","35219","47","157","47157","2010"
"Census Tract 35, Shelby County, Tennessee","256","712","403","17","1726","1388","338","703","685","1726","54227","47","157","47157","2010"
"Census Tract 36, Shelby County, Tennessee","199","470","132","49","1534","850","684","146","704","1534","32500","47","157","47157","2010"
"Census Tract 37, Shelby County, Tennessee","462","279","92","0","998","833","165","25","808","998","12438","47","157","47157","2010"
"Census Tract 38, Shelby County, Tennessee","452","343","11","9","905","815","90","11","804","905","13750","47","157","47157","2010"
"Census Tract 39, Shelby County, Tennessee","387","278","123","33","899","821","78","10","811","899","16020","47","157","47157","2010"
"Census Tract 42, Shelby County, Tennessee","267","830","269","29","1810","1395","415","417","978","1810","54063","47","157","47157","2010"
"Census Tract 43, Shelby County, Tennessee","110","477","160","17","1120","764","356","340","424","1120","83750","47","157","47157","2010"
"Census Tract 45, Shelby County, Tennessee","197","101","31","0","469","329","140","29","300","469","11544","47","157","47157","2010"
"Census Tract 46, Shelby County, Tennessee","194","146","25","0","547","365","182","25","340","547","15552","47","157","47157","2010"
"Census Tract 50, Shelby County, Tennessee","226","91","69","0","525","386","139","53","333","525","19554","47","157","47157","2010"
"Census Tract 53, Shelby County, Tennessee","699","606","119","60","2124","1484","640","800","684","2124","16365","47","157","47157","2010"
"Census Tract 55, Shelby County, Tennessee","482","446","82","97","1502","1107","395","489","618","1502","19669","47","157","47157","2010"
"Census Tract 56, Shelby County, Tennessee","762","620","180","52","1881","1614","267","971","643","1881","19430","47","157","47157","2010"
"Census Tract 57, Shelby County, Tennessee","275","532","180","42","1274","1029","245","475","554","1274","16529","47","157","47157","2010"
"Census Tract 58, Shelby County, Tennessee","177","206","15","0","665","398","267","160","238","665","15357","47","157","47157","2010"
"Census Tract 59, Shelby County, Tennessee","415","357","107","18","1371","897","474","438","459","1371","19070","47","157","47157","2010"
"Census Tract 60, Shelby County, Tennessee","292","416","87","8","1028","803","225","482","321","1028","28086","47","157","47157","2010"
"Census Tract 62, Shelby County, Tennessee","353","281","76","78","1172","788","384","423","365","1172","26488","47","157","47157","2010"
"Census Tract 63, Shelby County, Tennessee","173","545","358","41","1330","1117","213","713","404","1330","45972","47","157","47157","2010"
"Census Tract 64, Shelby County, Tennessee","183","240","168","0","852","591","261","402","189","852","39554","47","157","47157","2010"
"Census Tract 65, Shelby County, Tennessee","341","442","157","26","1183","966","217","434","532","1183","24975","47","157","47157","2010"
"Census Tract 66, Shelby County, Tennessee","213","577","244","41","1287","1075","212","477","598","1287","34554","47","157","47157","2010"
"Census Tract 67, Shelby County, Tennessee","744","529","81","53","1782","1407","375","417","990","1782","16445","47","157","47157","2010"
"Census Tract 68, Shelby County, Tennessee","501","505","21","52","1288","1079","209","599","480","1288","20259","47","157","47157","2010"
"Census Tract 69, Shelby County, Tennessee","450","358","236","92","1228","1136","92","738","398","1228","27417","47","157","47157","2010"
"Census Tract 70, Shelby County, Tennessee","434","583","244","18","1656","1279","377","394","885","1656","24620","47","157","47157","2010"
"Census Tract 71, Shelby County, Tennessee","284","429","222","10","1108","945","163","717","228","1108","77188","47","157","47157","2010"
"Census Tract 72, Shelby County, Tennessee","216","569","372","76","1327","1233","94","845","388","1327","67028","47","157","47157","2010"
"Census Tract 73, Shelby County, Tennessee","586","524","185","0","1581","1295","286","449","846","1581","30694","47","157","47157","2010"
"Census Tract 74, Shelby County, Tennessee","229","647","425","87","1574","1388","186","633","755","1574","37043","47","157","47157","2010"
"Census Tract 75, Shelby County, Tennessee","264","289","60","28","667","641","26","449","192","667","23832","47","157","47157","2010"
"Census Tract 78.10, Shelby County, Tennessee","576","411","170","28","1515","1185","330","371","814","1515","16927","47","157","47157","2010"
"Census Tract 78.21, Shelby County, Tennessee","1146","748","336","46","2602","2276","326","1190","1086","2602","21396","47","157","47157","2010"
"Census Tract 78.22, Shelby County, Tennessee","238","253","107","9","732","607","125","384","223","732","21181","47","157","47157","2010"
"Census Tract 79, Shelby County, Tennessee","830","805","308","96","2717","2039","678","1091","948","2717","27288","47","157","47157","2010"
"Census Tract 80, Shelby County, Tennessee","540","996","326","61","2357","1923","434","1297","626","2357","38166","47","157","47157","2010"
"Census Tract 81.10, Shelby County, Tennessee","293","366","199","168","1482","1026","456","354","672","1482","25969","47","157","47157","2010"
"Census Tract 81.20, Shelby County, Tennessee","588","998","491","29","2592","2106","486","1076","1030","2592","32110","47","157","47157","2010"
"Census Tract 82, Shelby County, Tennessee","551","605","343","175","2120","1674","446","870","804","2120","27206","47","157","47157","2010"
"Census Tract 85, Shelby County, Tennessee","506","830","385","19","1890","1740","150","1514","226","1890","118587","47","157","47157","2010"
"Census Tract 86, Shelby County, Tennessee","444","1161","625","99","2677","2329","348","1694","635","2677","73295","47","157","47157","2010"
"Census Tract 87, Shelby County, Tennessee","487","880","403","75","2140","1845","295","1307","538","2140","37310","47","157","47157","2010"
"Census Tract 88, Shelby County, Tennessee","591","823","557","49","2457","2020","437","1166","854","2457","36442","47","157","47157","2010"
"Census Tract 89, Shelby County, Tennessee","365","628","330","95","1736","1418","318","582","836","1736","28750","47","157","47157","2010"
"Census Tract 91, Shelby County, Tennessee","306","237","225","109","977","877","100","578","299","977","39034","47","157","47157","2010"
"Census Tract 92, Shelby County, Tennessee","757","1357","957","62","3347","3133","214","2519","614","3347","61049","47","157","47157","2010"
"Census Tract 93, Shelby County, Tennessee","551","902","507","75","2329","2035","294","1365","670","2329","49509","47","157","47157","2010"
"Census Tract 94, Shelby County, Tennessee","494","648","427","13","1708","1582","126","1241","341","1708","49049","47","157","47157","2010"
"Census Tract 95, Shelby County, Tennessee","558","1232","973","103","3144","2866","278","2526","340","3144","66368","47","157","47157","2010"
"Census Tract 96, Shelby County, Tennessee","595","676","617","35","2116","1923","193","1756","167","2116","97356","47","157","47157","2010"
"Census Tract 97, Shelby County, Tennessee","254","335","300","119","1116","1008","108","512","496","1116","33409","47","157","47157","2010"
"Census Tract 98, Shelby County, Tennessee","347","676","246","29","1335","1298","37","744","554","1335","31569","47","157","47157","2010"
"Census Tract 99.01, Shelby County, Tennessee","397","603","311","69","1747","1380","367","965","415","1747","28900","47","157","47157","2010"
"Census Tract 99.02, Shelby County, Tennessee","341","652","113","0","1432","1106","326","300","806","1432","19159","47","157","47157","2010"
"Census Tract 100, Shelby County, Tennessee","927","906","443","174","2834","2450","384","1679","771","2834","29118","47","157","47157","2010"
"Census Tract 101.10, Shelby County, Tennessee","608","1131","350","207","2872","2296","576","914","1382","2872","28425","47","157","47157","2010"
"Census Tract 101.20, Shelby County, Tennessee","759","771","267","61","2496","1858","638","671","1187","2496","21695","47","157","47157","2010"
"Census Tract 102.10, Shelby County, Tennessee","459","1113","188","82","2113","1842","271","946","896","2113","23627","47","157","47157","2010"
"Census Tract 102.20, Shelby County, Tennessee","612","1154","612","212","2836","2590","246","1674","916","2836","36337","47","157","47157","2010"
"Census Tract 103, Shelby County, Tennessee","196","199","127","50","640","572","68","363","209","640","21938","47","157","47157","2010"
"Census Tract 105, Shelby County, Tennessee","266","399","178","19","1413","862","551","110","752","1413","23696","47","157","47157","2010"
"Census Tract 106.10, Shelby County, Tennessee","399","1199","587","153","2663","2338","325","1157","1181","2663","33417","47","157","47157","2010"
"Census Tract 106.20, Shelby County, Tennessee","281","533","291","61","1626","1166","460","327","839","1626","28750","47","157","47157","2010"
"Census Tract 106.30, Shelby County, Tennessee","251","731","277","42","2360","1301","1059","487","814","2360","25483","47","157","47157","2010"
"Census Tract 107.10, Shelby County, Tennessee","176","588","569","92","1618","1425","193","1193","232","1618","52883","47","157","47157","2010"
"Census Tract 107.20, Shelby County, Tennessee","391","668","301","69","1732","1429","303","566","863","1732","30331","47","157","47157","2010"
"Census Tract 108.10, Shelby County, Tennessee","535","762","620","20","2321","1937","384","1029","908","2321","34026","47","157","47157","2010"
"Census Tract 108.20, Shelby County, Tennessee","221","691","528","79","1684","1519","165","1208","311","1684","51386","47","157","47157","2010"
"Census Tract 110.10, Shelby County, Tennessee","612","687","197","38","1696","1534","162","1012","522","1696","30197","47","157","47157","2010"
"Census Tract 110.20, Shelby County, Tennessee","132","450","46","0","1066","628","438","239","389","1066","32357","47","157","47157","2010"
"Census Tract 111, Shelby County, Tennessee","321","197","86","29","891","633","258","375","258","891","19150","47","157","47157","2010"
"Census Tract 112, Shelby County, Tennessee","447","251","52","9","1015","759","256","295","464","1015","9821","47","157","47157","2010"
"Census Tract 113, Shelby County, Tennessee","371","278","87","0","952","736","216","147","589","952","15880","47","157","47157","2010"
"Census Tract 114, Shelby County, Tennessee","945","390","114","11","1919","1460","459","26","1434","1919","9580","47","157","47157","2010"
"Census Tract 115, Shelby County, Tennessee","454","435","121","15","1431","1025","406","527","498","1431","19567","47","157","47157","2010"
"Census Tract 116, Shelby County, Tennessee","570","206","163","0","1325","939","386","276","663","1325","14441","47","157","47157","2010"
"Census Tract 117, Shelby County, Tennessee","221","194","88","27","768","530","238","218","312","768","28194","47","157","47157","2010"
"Census Tract 118, Shelby County, Tennessee","608","1028","453","46","2279","2135","144","1189","946","2279","34119","47","157","47157","2010"
"Census Tract 201.01, Shelby County, Tennessee","447","851","398","16","1837","1712","125","1005","707","1837","26684","47","157","47157","2010"
"Census Tract 201.02, Shelby County, Tennessee","274","367","327","152","1192","1120","72","991","129","1192","83500","47","157","47157","2010"
"Census Tract 202.10, Shelby County, Tennessee","503","932","547","155","2301","2137","164","1329","808","2301","43028","47","157","47157","2010"
"Census Tract 202.21, Shelby County, Tennessee","238","382","318","65","1093","1003","90","708","295","1093","54632","47","157","47157","2010"
"Census Tract 202.22, Shelby County, Tennessee","151","459","333","107","1141","1050","91","750","300","1141","49947","47","157","47157","2010"
"Census Tract 203, Shelby County, Tennessee","674","933","369","78","2281","2054","227","1173","881","2281","36983","47","157","47157","2010"
"Census Tract 204, Shelby County, Tennessee","7","205","122","0","384","334","50","0","334","384","46765","47","157","47157","2010"
"Census Tract 205.11, Shelby County, Tennessee","283","248","206","64","892","801","91","656","145","892","39950","47","157","47157","2010"
"Census Tract 205.12, Shelby County, Tennessee","678","877","610","53","3094","2218","876","726","1492","3094","32110","47","157","47157","2010"
"Census Tract 205.21, Shelby County, Tennessee","254","702","233","21","1370","1210","160","516","694","1370","22273","47","157","47157","2010"
"Census Tract 205.23, Shelby County, Tennessee","443","600","132","36","1543","1211","332","500","711","1543","23855","47","157","47157","2010"
"Census Tract 205.24, Shelby County, Tennessee","416","490","431","88","1728","1425","303","1095","330","1728","38429","47","157","47157","2010"
"Census Tract 205.31, Shelby County, Tennessee","184","677","588","119","1818","1568","250","1242","326","1818","51048","47","157","47157","2010"
"Census Tract 205.32, Shelby County, Tennessee","396","1011","591","239","2499","2237","262","1372","865","2499","41019","47","157","47157","2010"
"Census Tract 205.41, Shelby County, Tennessee","460","454","497","221","1973","1632","341","1270","362","1973","46389","47","157","47157","2010"
"Census Tract 205.42, Shelby County, Tennessee","527","861","522","3","2462","1913","549","369","1544","2462","30794","47","157","47157","2010"
"Census Tract 206.10, Shelby County, Tennessee","356","856","431","51","1890","1694","196","619","1075","1890","41297","47","157","47157","2010"
"Census Tract 206.21, Shelby County, Tennessee","465","1318","897","189","3111","2869","242","1433","1436","3111","53483","47","157","47157","2010"
"Census Tract 206.22, Shelby County, Tennessee","373","697","428","151","1752","1649","103","1056","593","1752","57026","47","157","47157","2010"
"Census Tract 206.32, Shelby County, Tennessee","279","756","747","210","1992","1992","0","1855","137","1992","74688","47","157","47157","2010"
"Census Tract 206.33, Shelby County, Tennessee","310","405","336","84","1168","1135","33","1064","71","1168","66066","47","157","47157","2010"
"Census Tract 206.34, Shelby County, Tennessee","232","389","376","106","1103","1103","0","1084","19","1103","72663","47","157","47157","2010"
"Census Tract 206.35, Shelby County, Tennessee","191","300","476","75","1042","1042","0","905","137","1042","65081","47","157","47157","2010"
"Census Tract 206.42, Shelby County, Tennessee","249","895","1099","273","2663","2516","147","2319","197","2663","88986","47","157","47157","2010"
"Census Tract 206.43, Shelby County, Tennessee","454","1160","959","299","3119","2872","247","2574","298","3119","85066","47","157","47157","2010"
"Census Tract 206.44, Shelby County, Tennessee","468","1348","1212","225","3462","3253","209","2766","487","3462","63836","47","157","47157","2010"
"Census Tract 206.51, Shelby County, Tennessee","502","934","898","157","2561","2491","70","2154","337","2561","58205","47","157","47157","2010"
"Census Tract 206.52, Shelby County, Tennessee","361","843","697","182","2138","2083","55","1780","303","2138","66439","47","157","47157","2010"
"Census Tract 207, Shelby County, Tennessee","273","189","371","73","960","906","54","820","86","960","78438","47","157","47157","2010"
"Census Tract 208.10, Shelby County, Tennessee","221","430","382","69","1149","1102","47","969","133","1149","57895","47","157","47157","2010"
"Census Tract 208.20, Shelby County, Tennessee","398","929","923","103","2496","2353","143","2123","230","2496","79202","47","157","47157","2010"
"Census Tract 208.31, Shelby County, Tennessee","183","874","593","54","1841","1704","137","1261","443","1841","62743","47","157","47157","2010"
"Census Tract 208.32, Shelby County, Tennessee","328","961","1158","230","2836","2677","159","2165","512","2836","106372","47","157","47157","2010"
"Census Tract 209, Shelby County, Tennessee","151","902","1164","238","2624","2455","169","2317","138","2624","91902","47","157","47157","2010"
"Census Tract 210.10, Shelby County, Tennessee","657","2028","1803","312","5296","4800","496","3635","1165","5296","63530","47","157","47157","2010"
"Census Tract 210.20, Shelby County, Tennessee","236","753","675","175","2120","1839","281","1715","124","2120","101213","47","157","47157","2010"
"Census Tract 211.11, Shelby County, Tennessee","193","727","447","67","1670","1434","236","573","861","1670","36649","47","157","47157","2010"
"Census Tract 211.12, Shelby County, Tennessee","454","1185","809","135","2658","2583","75","1456","1127","2658","44652","47","157","47157","2010"
"Census Tract 211.13, Shelby County, Tennessee","58","755","420","98","1389","1331","58","954","377","1389","60221","47","157","47157","2010"
"Census Tract 211.21, Shelby County, Tennessee","471","1125","639","29","2585","2264","321","525","1739","2585","42344","47","157","47157","2010"
"Census Tract 211.22, Shelby County, Tennessee","314","1109","635","95","2468","2153","315","1084","1069","2468","44757","47","157","47157","2010"
"Census Tract 211.24, Shelby County, Tennessee","321","1087","1146","90","3005","2644","361","1877","767","3005","58116","47","157","47157","2010"
"Census Tract 211.25, Shelby County, Tennessee","297","859","573","12","1886","1741","145","1310","431","1886","68973","47","157","47157","2010"
"Census Tract 211.26, Shelby County, Tennessee","300","952","605","65","2128","1922","206","720","1202","2128","54167","47","157","47157","2010"
"Census Tract 211.35, Shelby County, Tennessee","349","1417","961","37","2938","2764","174","1710","1054","2938","58300","47","157","47157","2010"
"Census Tract 211.36, Shelby County, Tennessee","194","612","716","182","1782","1704","78","1509","195","1782","105969","47","157","47157","2010"
"Census Tract 211.37, Shelby County, Tennessee","490","1455","1228","182","3544","3355","189","2556","799","3544","65887","47","157","47157","2010"
"Census Tract 211.38, Shelby County, Tennessee","145","430","505","64","1276","1144","132","745","399","1276","85714","47","157","47157","2010"
"Census Tract 211.39, Shelby County, Tennessee","121","590","563","70","1418","1344","74","1335","9","1418","106667","47","157","47157","2010"
"Census Tract 211.40, Shelby County, Tennessee","246","778","854","122","2123","2000","123","1105","895","2123","61747","47","157","47157","2010"
"Census Tract 211.41, Shelby County, Tennessee","338","1101","932","162","2873","2533","340","2087","446","2873","74331","47","157","47157","2010"
"Census Tract 211.42, Shelby County, Tennessee","327","651","382","107","1679","1467","212","929","538","1679","62474","47","157","47157","2010"
"Census Tract 212, Shelby County, Tennessee","0","0","0","0","0","0","0","0","0","0","-666666666","47","157","47157","2010"
"Census Tract 213.11, Shelby County, Tennessee","771","894","428","15","2269","2108","161","1576","532","2269","124531","47","157","47157","2010"
"Census Tract 213.12, Shelby County, Tennessee","237","622","275","24","1289","1158","131","516","642","1289","34749","47","157","47157","2010"
"Census Tract 213.20, Shelby County, Tennessee","418","1088","867","99","2955","2472","483","1466","1006","2955","53843","47","157","47157","2010"
"Census Tract 213.31, Shelby County, Tennessee","321","589","375","62","1406","1347","59","1287","60","1406","69676","47","157","47157","2010"
"Census Tract 213.33, Shelby County, Tennessee","274","627","612","96","1713","1609","104","1079","530","1713","61150","47","157","47157","2010"
"Census Tract 213.34, Shelby County, Tennessee","116","964","477","34","1813","1591","222","607","984","1813","43696","47","157","47157","2010"
"Census Tract 213.41, Shelby County, Tennessee","384","740","648","103","1905","1875","30","1712","163","1905","129129","47","157","47157","2010"
"Census Tract 213.42, Shelby County, Tennessee","577","1727","1010","178","4141","3492","649","1762","1730","4141","66720","47","157","47157","2010"
"Census Tract 213.51, Shelby County, Tennessee","613","664","621","49","2191","1947","244","1273","674","2191","82703","47","157","47157","2010"
"Census Tract 213.52, Shelby County, Tennessee","446","884","937","211","2510","2478","32","2435","43","2510","117766","47","157","47157","2010"
"Census Tract 213.53, Shelby County, Tennessee","232","1253","1335","219","3111","3039","72","2991","48","3111","161350","47","157","47157","2010"
"Census Tract 214.10, Shelby County, Tennessee","214","390","397","56","1167","1057","110","889","168","1167","89338","47","157","47157","2010"
"Census Tract 214.20, Shelby County, Tennessee","266","616","445","82","1424","1409","15","1130","279","1424","81386","47","157","47157","2010"
"Census Tract 214.30, Shelby County, Tennessee","344","789","474","93","1738","1700","38","1453","247","1738","85775","47","157","47157","2010"
"Census Tract 215.10, Shelby County, Tennessee","370","1504","1074","100","3473","3048","425","1526","1522","3473","57209","47","157","47157","2010"
"Census Tract 215.20, Shelby County, Tennessee","401","1503","1035","265","3580","3204","376","2333","871","3580","98947","47","157","47157","2010"
"Census Tract 215.30, Shelby County, Tennessee","308","637","703","105","1818","1753","65","1495","258","1818","121042","47","157","47157","2010"
"Census Tract 215.40, Shelby County, Tennessee","292","1355","1367","216","3488","3230","258","2985","245","3488","134402","47","157","47157","2010"
"Census Tract 216.11, Shelby County, Tennessee","292","956","642","143","2113","2033","80","1850","183","2113","77317","47","157","47157","2010"
"Census Tract 216.12, Shelby County, Tennessee","219","450","706","183","1558","1558","0","1469","89","1558","96800","47","157","47157","2010"
"Census Tract 216.13, Shelby County, Tennessee","168","569","571","118","1465","1426","39","1292","134","1465","91932","47","157","47157","2010"
"Census Tract 216.20, Shelby County, Tennessee","284","589","173","68","1150","1114","36","511","603","1150","29302","47","157","47157","2010"
"Census Tract 217.10, Shelby County, Tennessee","239","746","180","20","1382","1185","197","218","967","1382","21128","47","157","47157","2010"
"Census Tract 217.21, Shelby County, Tennessee","366","901","275","69","2214","1611","603","349","1262","2214","29120","47","157","47157","2010"
"Census Tract 217.24, Shelby County, Tennessee","175","519","195","51","1002","940","62","325","615","1002","31218","47","157","47157","2010"
"Census Tract 217.25, Shelby County, Tennessee","200","1466","266","70","2601","2002","599","144","1858","2601","23218","47","157","47157","2010"
"Census Tract 217.26, Shelby County, Tennessee","1094","886","156","49","2733","2185","548","169","2016","2733","22099","47","157","47157","2010"
"Census Tract 217.31, Shelby County, Tennessee","129","484","188","63","1394","864","530","517","347","1394","33773","47","157","47157","2010"
"Census Tract 217.32, Shelby County, Tennessee","434","1439","610","137","2940","2620","320","908","1712","2940","30273","47","157","47157","2010"
"Census Tract 217.41, Shelby County, Tennessee","317","1324","856","135","2838","2632","206","1704","928","2838","41975","47","157","47157","2010"
"Census Tract 217.44, Shelby County, Tennessee","312","753","646","213","2177","1924","253","1604","320","2177","64292","47","157","47157","2010"
"Census Tract 217.45, Shelby County, Tennessee","388","891","941","232","2657","2452","205","2201","251","2657","64967","47","157","47157","2010"
"Census Tract 217.46, Shelby County, Tennessee","259","1039","467","97","1998","1862","136","1350","512","1998","39153","47","157","47157","2010"
"Census Tract 217.47, Shelby County, Tennessee","232","635","370","61","1399","1298","101","1000","298","1399","50586","47","157","47157","2010"
"Census Tract 217.51, Shelby County, Tennessee","218","977","810","117","2249","2122","127","1880","242","2249","68462","47","157","47157","2010"
"Census Tract 217.52, Shelby County, Tennessee","84","481","618","173","1470","1356","114","1277","79","1470","86700","47","157","47157","2010"
"Census Tract 217.53, Shelby County, Tennessee","120","510","385","81","1233","1096","137","962","134","1233","61622","47","157","47157","2010"
"Census Tract 217.54, Shelby County, Tennessee","209","799","526","130","1708","1664","44","1206","458","1708","52917","47","157","47157","2010"
"Census Tract 219, Shelby County, Tennessee","327","1028","463","43","2002","1861","141","1365","496","2002","36118","47","157","47157","2010"
"Census Tract 220.22, Shelby County, Tennessee","488","791","225","22","2898","1526","1372","323","1203","2898","31118","47","157","47157","2010"
"Census Tract 220.23, Shelby County, Tennessee","204","661","198","0","1657","1063","594","318","745","1657","27729","47","157","47157","2010"
"Census Tract 220.24, Shelby County, Tennessee","424","521","432","39","1618","1416","202","1026","390","1618","41968","47","157","47157","2010"
"Census Tract 221.11, Shelby County, Tennessee","821","753","218","130","2455","1922","533","648","1274","2455","29866","47","157","47157","2010"
"Census Tract 221.12, Shelby County, Tennessee","528","1178","225","153","2589","2084","505","788","1296","2589","34085","47","157","47157","2010"
"Census Tract 221.21, Shelby County, Tennessee","293","724","373","141","1772","1531","241","1313","218","1772","50104","47","157","47157","2010"
"Census Tract 221.22, Shelby County, Tennessee","320","707","328","59","1915","1414","501","773","641","1915","47845","47","157","47157","2010"
"Census Tract 221.30, Shelby County, Tennessee","557","917","494","144","2363","2112","251","1404","708","2363","40766","47","157","47157","2010"
"Census Tract 222.10, Shelby County, Tennessee","629","647","322","39","1834","1637","197","1335","302","1834","31178","47","157","47157","2010"
"Census Tract 222.20, Shelby County, Tennessee","781","567","186","69","1852","1603","249","832","771","1852","23831","47","157","47157","2010"
"Census Tract 223.10, Shelby County, Tennessee","587","749","372","23","2024","1731","293","1398","333","2024","27522","47","157","47157","2010"
"Census Tract 223.21, Shelby County, Tennessee","458","527","376","81","1581","1442","139","827","615","1581","31346","47","157","47157","2010"
"Census Tract 223.22, Shelby County, Tennessee","395","792","309","48","1682","1544","138","1340","204","1682","36182","47","157","47157","2010"
"Census Tract 223.30, Shelby County, Tennessee","506","664","333","63","1735","1566","169","1058","508","1735","34147","47","157","47157","2010"
"Census Tract 224.10, Shelby County, Tennessee","620","1053","523","83","2476","2279","197","1944","335","2476","43040","47","157","47157","2010"
"Census Tract 225, Shelby County, Tennessee","392","662","285","199","2223","1538","685","1102","436","2223","46795","47","157","47157","2010"
"Census Tract 226, Shelby County, Tennessee","334","606","250","40","1826","1230","596","660","570","1826","28941","47","157","47157","2010"
"Census Tract 227, Shelby County, Tennessee","1100","821","480","126","2742","2527","215","1708","819","2742","29908","47","157","47157","2010"
"Census Tract 9801, Shelby County, Tennessee","0","0","0","0","0","0","0","0","0","0","-666666666","47","157","47157","2010"
"Census Tract 9802, Shelby County, Tennessee","0","0","0","0","0","0","0","0","0","0","-666666666","47","157","47157","2010"
"Census Tract 9803, Shelby County, Tennessee","0","0","0","0","0","0","0","0","0","0","-666666666","47","157","47157","2010"
"Census Tract 9804, Shelby County, Tennessee","0","0","0","0","0","0","0","0","0","0","-666666666","47","157","47157","2010"
"Census Tract 9750, Smith County, Tennessee","422","502","351","61","1860","1336","524","1049","287","1860","42840","47","159","47159","2010"
"Census Tract 9751, Smith County, Tennessee","377","430","257","22","1308","1086","222","614","472","1308","36944","47","159","47159","2010"
"Census Tract 9752, Smith County, Tennessee","562","727","574","96","2326","1959","367","1475","484","2326","44297","47","159","47159","2010"
"Census Tract 9753, Smith County, Tennessee","304","240","173","62","980","779","201","657","122","980","39209","47","159","47159","2010"
"Census Tract 9754, Smith County, Tennessee","492","564","590","31","1954","1677","277","1442","235","1954","48131","47","159","47159","2010"
"Census Tract 1102, Stewart County, Tennessee","970","828","490","115","3042","2403","639","1941","462","3042","43443","47","161","47161","2010"
"Census Tract 1106, Stewart County, Tennessee","457","283","255","72","1292","1067","225","866","201","1292","36631","47","161","47161","2010"
"Census Tract 1107, Stewart County, Tennessee","801","651","397","64","2341","1913","428","1552","361","2341","37287","47","161","47161","2010"
"Census Tract 9801, Stewart County, Tennessee","0","0","0","0","0","0","0","0","0","0","-666666666","47","161","47161","2010"
"Census Tract 9802, Stewart County, Tennessee","0","0","0","0","0","0","0","0","0","0","-666666666","47","161","47161","2010"
"Census Tract 402, Sullivan County, Tennessee","531","367","192","25","1378","1115","263","432","683","1378","21794","47","163","47163","2010"
"Census Tract 403, Sullivan County, Tennessee","539","625","217","35","1554","1416","138","832","584","1554","31722","47","163","47163","2010"
"Census Tract 405, Sullivan County, Tennessee","856","628","411","42","2176","1937","239","1149","788","2176","28225","47","163","47163","2010"
"Census Tract 406, Sullivan County, Tennessee","889","261","215","29","1647","1394","253","658","736","1647","18022","47","163","47163","2010"
"Census Tract 407, Sullivan County, Tennessee","543","357","249","13","1223","1162","61","884","278","1223","48348","47","163","47163","2010"
"Census Tract 408, Sullivan County, Tennessee","724","357","396","67","1698","1544","154","981","563","1698","27133","47","163","47163","2010"
"Census Tract 409, Sullivan County, Tennessee","493","585","219","11","1517","1308","209","924","384","1517","60128","47","163","47163","2010"
"Census Tract 410, Sullivan County, Tennessee","433","481","472","163","1668","1549","119","1431","118","1668","56225","47","163","47163","2010"
"Census Tract 411, Sullivan County, Tennessee","435","348","324","105","1277","1212","65","950","262","1277","42800","47","163","47163","2010"
"Census Tract 412, Sullivan County, Tennessee","822","1016","838","158","3039","2834","205","2191","643","3039","53805","47","163","47163","2010"
"Census Tract 413, Sullivan County, Tennessee","443","558","458","208","1816","1667","149","1475","192","1816","50696","47","163","47163","2010"
"Census Tract 414, Sullivan County, Tennessee","842","830","684","92","2572","2448","124","2009","439","2572","41319","47","163","47163","2010"
"Census Tract 415, Sullivan County, Tennessee","372","585","312","25","1352","1294","58","1056","238","1352","67500","47","163","47163","2010"
"Census Tract 416, Sullivan County, Tennessee","305","445","337","57","1265","1144","121","824","320","1265","45833","47","163","47163","2010"
"Census Tract 417, Sullivan County, Tennessee","685","571","241","117","1717","1614","103","1213","401","1717","28693","47","163","47163","2010"
"Census Tract 418, Sullivan County, Tennessee","885","790","407","112","2452","2194","258","1281","913","2452","27587","47","163","47163","2010"
"Census Tract 419, Sullivan County, Tennessee","529","451","385","42","1565","1407","158","1161","246","1565","35353","47","163","47163","2010"
"Census Tract 420, Sullivan County, Tennessee","553","523","390","25","1629","1491","138","1288","203","1629","41326","47","163","47163","2010"
"Census Tract 421, Sullivan County, Tennessee","1067","720","487","105","2662","2379","283","1621","758","2662","41649","47","163","47163","2010"
"Census Tract 422, Sullivan County, Tennessee","345","417","382","83","1253","1227","26","1116","111","1253","56563","47","163","47163","2010"
"Census Tract 423, Sullivan County, Tennessee","653","992","766","213","2919","2624","295","2239","385","2919","53813","47","163","47163","2010"
"Census Tract 424, Sullivan County, Tennessee","478","537","303","58","1535","1376","159","1191","185","1535","44677","47","163","47163","2010"
"Census Tract 425, Sullivan County, Tennessee","507","461","384","121","1530","1473","57","1195","278","1530","43958","47","163","47163","2010"
"Census Tract 426, Sullivan County, Tennessee","635","939","367","73","2143","2014","129","1565","449","2143","36750","47","163","47163","2010"
"Census Tract 427.01, Sullivan County, Tennessee","969","867","502","93","2567","2431","136","1144","1287","2567","30264","47","163","47163","2010"
"Census Tract 427.02, Sullivan County, Tennessee","345","440","205","31","1099","1021","78","809","212","1099","31464","47","163","47163","2010"
"Census Tract 428.01, Sullivan County, Tennessee","505","407","183","34","1242","1129","113","890","239","1242","37250","47","163","47163","2010"
"Census Tract 428.02, Sullivan County, Tennessee","686","589","370","54","2117","1699","418","1145","554","2117","34976","47","163","47163","2010"
"Census Tract 429, Sullivan County, Tennessee","541","714","468","90","1946","1813","133","1471","342","1946","55409","47","163","47163","2010"
"Census Tract 430, Sullivan County, Tennessee","660","719","459","54","2190","1892","298","1628","264","2190","36369","47","163","47163","2010"
"Census Tract 431, Sullivan County, Tennessee","456","400","375","29","1489","1260","229","965","295","1489","33375","47","163","47163","2010"
"Census Tract 432.01, Sullivan County, Tennessee","446","388","682","119","1731","1635","96","1572","63","1731","52901","47","163","47163","2010"
"Census Tract 432.02, Sullivan County, Tennessee","825","779","403","45","2241","2052","189","1722","330","2241","29226","47","163","47163","2010"
"Census Tract 433.01, Sullivan County, Tennessee","367","840","783","101","2397","2091","306","1638","453","2397","49125","47","163","47163","2010"
"Census Tract 433.02, Sullivan County, Tennessee","846","993","552","41","2661","2432","229","1891","541","2661","34042","47","163","47163","2010"
"Census Tract 434.01, Sullivan County, Tennessee","550","777","726","66","2364","2119","245","1708","411","2364","39540","47","163","47163","2010"
"Census Tract 434.02, Sullivan County, Tennessee","689","630","465","50","1990","1834","156","1332","502","1990","34688","47","163","47163","2010"
"Census Tract 435, Sullivan County, Tennessee","322","667","414","47","1629","1450","179","1309","141","1629","52917","47","163","47163","2010"
"Census Tract 436, Sullivan County, Tennessee","521","654","627","101","2101","1903","198","1555","348","2101","60822","47","163","47163","2010"
"Census Tract 201.01, Sumner County, Tennessee","237","520","390","45","1342","1192","150","1052","140","1342","51090","47","165","47165","2010"
"Census Tract 201.02, Sumner County, Tennessee","681","699","545","60","2119","1985","134","1565","420","2119","34205","47","165","47165","2010"
"Census Tract 202.03, Sumner County, Tennessee","109","236","287","33","804","665","139","616","49","804","63259","47","165","47165","2010"
"Census Tract 202.04, Sumner County, Tennessee","90","325","452","51","1036","918","118","823","95","1036","64000","47","165","47165","2010"
"Census Tract 202.05, Sumner County, Tennessee","178","485","235","59","1006","957","49","807","150","1006","60479","47","165","47165","2010"
"Census Tract 202.06, Sumner County, Tennessee","63","215","148","24","528","450","78","326","124","528","64583","47","165","47165","2010"
"Census Tract 202.07, Sumner County, Tennessee","147","328","125","18","675","618","57","445","173","675","59500","47","165","47165","2010"
"Census Tract 202.08, Sumner County, Tennessee","193","501","181","11","1044","886","158","664","222","1044","35743","47","165","47165","2010"
"Census Tract 202.09, Sumner County, Tennessee","119","311","237","33","775","700","75","577","123","775","47059","47","165","47165","2010"
"Census Tract 203, Sumner County, Tennessee","504","896","460","106","2053","1966","87","1055","911","2053","30517","47","165","47165","2010"
"Census Tract 204.03, Sumner County, Tennessee","144","314","159","103","750","720","30","507","213","750","46797","47","165","47165","2010"
"Census Tract 204.04, Sumner County, Tennessee","216","234","279","35","814","764","50","643","121","814","52500","47","165","47165","2010"
"Census Tract 204.05, Sumner County, Tennessee","285","288","188","38","825","799","26","634","165","825","54484","47","165","47165","2010"
"Census Tract 204.06, Sumner County, Tennessee","241","355","462","105","1163","1163","0","1027","136","1163","64088","47","165","47165","2010"
"Census Tract 204.07, Sumner County, Tennessee","196","508","651","117","1506","1472","34","1313","159","1506","61324","47","165","47165","2010"
"Census Tract 205.01, Sumner County, Tennessee","356","613","545","46","1769","1560","209","1088","472","1769","73911","47","165","47165","2010"
"Census Tract 205.02, Sumner County, Tennessee","268","491","338","165","1314","1262","52","1176","86","1314","64015","47","165","47165","2010"
"Census Tract 205.03, Sumner County, Tennessee","182","404","173","16","837","775","62","708","67","837","48504","47","165","47165","2010"
"Census Tract 206.01, Sumner County, Tennessee","289","541","384","61","1416","1275","141","1167","108","1416","56806","47","165","47165","2010"
"Census Tract 206.02, Sumner County, Tennessee","398","466","416","129","1550","1409","141","1173","236","1550","53146","47","165","47165","2010"
"Census Tract 206.03, Sumner County, Tennessee","252","487","411","57","1401","1207","194","1104","103","1401","56464","47","165","47165","2010"
"Census Tract 207, Sumner County, Tennessee","821","668","524","58","2263","2071","192","1107","964","2263","34934","47","165","47165","2010"
"Census Tract 208, Sumner County, Tennessee","855","741","654","220","2758","2470","288","1098","1372","2758","29620","47","165","47165","2010"
"Census Tract 209.01, Sumner County, Tennessee","213","160","100","18","564","491","73","402","89","564","39952","47","165","47165","2010"
"Census Tract 209.02, Sumner County, Tennessee","656","1180","640","196","3003","2672","331","1443","1229","3003","35635","47","165","47165","2010"
"Census Tract 209.03, Sumner County, Tennessee","343","868","403","120","1809","1734","75","1114","620","1809","52653","47","165","47165","2010"
"Census Tract 210.02, Sumner County, Tennessee","338","732","940","217","2389","2227","162","1851","376","2389","80260","47","165","47165","2010"
"Census Tract 210.04, Sumner County, Tennessee","408","682","315","132","1587","1537","50","1240","297","1587","42762","47","165","47165","2010"
"Census Tract 210.05, Sumner County, Tennessee","476","753","810","89","2301","2128","173","1827","301","2301","77578","47","165","47165","2010"
"Census Tract 210.06, Sumner County, Tennessee","102","509","299","116","1093","1026","67","956","70","1093","88317","47","165","47165","2010"
"Census Tract 210.07, Sumner County, Tennessee","78","133","205","29","453","445","8","445","0","453","86563","47","165","47165","2010"
"Census Tract 210.08, Sumner County, Tennessee","194","396","589","20","1199","1199","0","1112","87","1199","110380","47","165","47165","2010"
"Census Tract 210.09, Sumner County, Tennessee","446","653","533","133","2004","1765","239","1198","567","2004","49640","47","165","47165","2010"
"Census Tract 211.03, Sumner County, Tennessee","547","752","716","127","2232","2142","90","1764","378","2232","62598","47","165","47165","2010"
"Census Tract 211.04, Sumner County, Tennessee","253","294","162","71","780","780","0","701","79","780","39890","47","165","47165","2010"
"Census Tract 211.05, Sumner County, Tennessee","405","1210","972","150","2875","2737","138","1177","1560","2875","50614","47","165","47165","2010"
"Census Tract 211.06, Sumner County, Tennessee","649","775","357","30","1889","1811","78","864","947","1889","34063","47","165","47165","2010"
"Census Tract 211.07, Sumner County, Tennessee","452","823","413","156","1923","1844","79","1141","703","1923","54885","47","165","47165","2010"
"Census Tract 212.01, Sumner County, Tennessee","459","659","773","231","2251","2122","129","2072","50","2251","100931","47","165","47165","2010"
"Census Tract 212.03, Sumner County, Tennessee","306","803","519","134","1907","1762","145","1524","238","1907","79167","47","165","47165","2010"
"Census Tract 212.04, Sumner County, Tennessee","554","1189","955","107","3028","2805","223","2010","795","3028","66089","47","165","47165","2010"
"Census Tract 212.05, Sumner County, Tennessee","249","397","339","7","1036","992","44","943","49","1036","76979","47","165","47165","2010"
"Census Tract 401, Tipton County, Tennessee","449","718","411","111","1935","1689","246","1304","385","1935","47010","47","167","47167","2010"
"Census Tract 402, Tipton County, Tennessee","256","278","268","30","925","832","93","675","157","925","43929","47","167","47167","2010"
"Census Tract 403.02, Tipton County, Tennessee","517","995","1023","303","2935","2838","97","2433","405","2935","78058","47","167","47167","2010"
"Census Tract 403.03, Tipton County, Tennessee","350","965","757","152","2523","2224","299","1752","472","2523","60986","47","167","47167","2010"
"Census Tract 403.04, Tipton County, Tennessee","570","1104","657","121","2522","2452","70","1957","495","2522","54195","47","167","47167","2010"
"Census Tract 404, Tipton County, Tennessee","301","447","384","128","1350","1260","90","927","333","1350","47139","47","167","47167","2010"
"Census Tract 405, Tipton County, Tennessee","390","943","545","153","2227","2031","196","1486","545","2227","51381","47","167","47167","2010"
"Census Tract 406.01, Tipton County, Tennessee","488","607","393","152","1841","1640","201","1243","397","1841","37012","47","167","47167","2010"
"Census Tract 406.02, Tipton County, Tennessee","299","472","250","86","1219","1107","112","724","383","1219","38307","47","167","47167","2010"
"Census Tract 407, Tipton County, Tennessee","772","755","303","65","1967","1895","72","684","1211","1967","19567","47","167","47167","2010"
"Census Tract 408, Tipton County, Tennessee","270","673","453","109","1568","1505","63","1424","81","1568","61348","47","167","47167","2010"
"Census Tract 409, Tipton County, Tennessee","146","318","214","0","691","678","13","490","188","691","39534","47","167","47167","2010"
"Census Tract 410, Tipton County, Tennessee","356","342","347","39","1159","1084","75","656","428","1159","35645","47","167","47167","2010"
"Census Tract 901, Trousdale County, Tennessee","567","429","771","96","2185","1863","322","1576","287","2185","51755","47","169","47169","2010"
"Census Tract 902, Trousdale County, Tennessee","321","401","154","75","1150","951","199","664","287","1150","27004","47","169","47169","2010"
"Census Tract 801, Unicoi County, Tennessee","590","371","162","65","1489","1188","301","830","358","1489","26543","47","171","47171","2010"
"Census Tract 802, Unicoi County, Tennessee","1045","856","680","88","2902","2669","233","1916","753","2902","34583","47","171","47171","2010"
"Census Tract 803, Unicoi County, Tennessee","507","682","648","110","2283","1947","336","1483","464","2283","44806","47","171","47171","2010"
"Census Tract 804, Unicoi County, Tennessee","866","543","366","21","2113","1796","317","1231","565","2113","29802","47","171","47171","2010"
"Census Tract 401, Union County, Tennessee","924","1062","588","84","3024","2658","366","2118","540","3024","29375","47","173","47173","2010"
"Census Tract 402.01, Union County, Tennessee","621","629","276","58","1765","1584","181","1026","558","1765","24438","47","173","47173","2010"
"Census Tract 402.02, Union County, Tennessee","650","864","629","95","2741","2238","503","1983","255","2741","36898","47","173","47173","2010"
"Census Tract 403, Union County, Tennessee","377","315","191","27","1373","910","463","817","93","1373","32778","47","173","47173","2010"
"Census Tract 9250, Van Buren County, Tennessee","260","258","237","73","1101","828","273","712","116","1101","31221","47","175","47175","2010"
"Census Tract 9252, Van Buren County, Tennessee","613","429","196","30","1539","1268","271","1052","216","1539","23617","47","175","47175","2010"
"Census Tract 9301, Warren County, Tennessee","398","546","300","64","1593","1308","285","1099","209","1593","35353","47","177","47177","2010"
"Census Tract 9302, Warren County, Tennessee","826","850","479","195","2921","2350","571","1985","365","2921","38077","47","177","47177","2010"
"Census Tract 9303, Warren County, Tennessee","285","295","364","68","1161","1012","149","904","108","1161","43500","47","177","47177","2010"
"Census Tract 9304, Warren County, Tennessee","801","972","484","35","2692","2292","400","1176","1116","2692","30000","47","177","47177","2010"
"Census Tract 9305, Warren County, Tennessee","573","952","288","25","2116","1838","278","1112","726","2116","27208","47","177","47177","2010"
"Census Tract 9306, Warren County, Tennessee","701","448","365","42","1859","1556","303","1051","505","1859","27500","47","177","47177","2010"
"Census Tract 9307, Warren County, Tennessee","603","817","410","14","2074","1844","230","1219","625","2074","37250","47","177","47177","2010"
"Census Tract 9308, Warren County, Tennessee","558","910","557","84","2443","2109","334","1780","329","2443","45404","47","177","47177","2010"
"Census Tract 9309, Warren County, Tennessee","200","296","165","24","818","685","133","623","62","818","28533","47","177","47177","2010"
"Census Tract 601, Washington County, Tennessee","632","634","221","14","1895","1501","394","550","951","1895","19250","47","179","47179","2010"
"Census Tract 604, Washington County, Tennessee","913","884","608","106","2818","2511","307","1981","530","2818","62160","47","179","47179","2010"
"Census Tract 605.01, Washington County, Tennessee","650","845","348","56","2207","1899","308","1399","500","2207","30900","47","179","47179","2010"
"Census Tract 605.02, Washington County, Tennessee","510","1074","678","140","2836","2402","434","1357","1045","2836","41082","47","179","47179","2010"
"Census Tract 606, Washington County, Tennessee","901","1476","547","138","3357","3062","295","1578","1484","3357","34988","47","179","47179","2010"
"Census Tract 607, Washington County, Tennessee","0","0","0","0","0","0","0","0","0","0","-666666666","47","179","47179","2010"
"Census Tract 608, Washington County, Tennessee","395","708","193","57","1641","1353","288","644","709","1641","33575","47","179","47179","2010"
"Census Tract 609, Washington County, Tennessee","910","926","431","44","2511","2311","200","625","1686","2511","20260","47","179","47179","2010"
"Census Tract 610, Washington County, Tennessee","434","392","125","80","1293","1031","262","455","576","1293","25525","47","179","47179","2010"
"Census Tract 611, Washington County, Tennessee","840","795","495","56","2275","2186","89","1529","657","2275","44015","47","179","47179","2010"
"Census Tract 612, Washington County, Tennessee","390","636","284","11","1606","1321","285","887","434","1606","29923","47","179","47179","2010"
"Census Tract 613, Washington County, Tennessee","1055","1385","785","147","3662","3372","290","2149","1223","3662","47616","47","179","47179","2010"
"Census Tract 614.01, Washington County, Tennessee","664","762","601","13","2463","2040","423","1591","449","2463","41182","47","179","47179","2010"
"Census Tract 614.02, Washington County, Tennessee","461","973","889","58","2822","2381","441","1716","665","2822","65656","47","179","47179","2010"
"Census Tract 615, Washington County, Tennessee","606","1095","984","114","3126","2799","327","1986","813","3126","44760","47","179","47179","2010"
"Census Tract 616.01, Washington County, Tennessee","437","434","499","92","1558","1462","96","1342","120","1558","49145","47","179","47179","2010"
"Census Tract 616.02, Washington County, Tennessee","960","1151","1214","230","3718","3555","163","3229","326","3718","49415","47","179","47179","2010"
"Census Tract 617.01, Washington County, Tennessee","473","922","519","38","2283","1952","331","1523","429","2283","60966","47","179","47179","2010"
"Census Tract 617.02, Washington County, Tennessee","903","929","726","175","3181","2733","448","2014","719","3181","42026","47","179","47179","2010"
"Census Tract 618, Washington County, Tennessee","948","899","881","93","3030","2821","209","2379","442","3030","46456","47","179","47179","2010"
"Census Tract 619.01, Washington County, Tennessee","864","1052","705","134","3109","2755","354","2280","475","3109","39369","47","179","47179","2010"
"Census Tract 619.02, Washington County, Tennessee","547","696","535","46","2160","1824","336","1524","300","2160","46466","47","179","47179","2010"
"Census Tract 620, Washington County, Tennessee","626","873","275","66","2140","1840","300","603","1237","2140","25254","47","179","47179","2010"
"Census Tract 9501, Wayne County, Tennessee","417","462","239","66","1497","1184","313","1034","150","1497","35800","47","181","47181","2010"
"Census Tract 9502, Wayne County, Tennessee","830","653","411","129","2605","2023","582","1638","385","2605","31012","47","181","47181","2010"
"Census Tract 9503, Wayne County, Tennessee","533","506","269","105","1637","1413","224","1166","247","1637","37218","47","181","47181","2010"
